	indoor/outdoor	primary sound source	comments	difficulty: easy=visually indicated sound, few sound sources. no entry = too hard	disqualified (for any other reason), e.g., content
_65lEmHZ3hQ	indoor	band			
_8_Hs2lWo5o	outdoor	music, crowd			
_al-w6QJGHA	fake				
_CmRj4bNFgk	outdoor	traffic	good	easy	
_G6HYMRFGJE	fake				
HzaPzTNjauY	fake				
_k7WuHPQeYw	fake				
_kg76aCZxoU	indoor	band			
_n9lMt_JIG0	edited sound				
_NHK8xO__BQ	indoor	band			
_oqIojnWZH4	fake				
_Otf6mHiLIo	fake				
_RdSWq5RaGk	edited sound				
_s-CWZ3Jmg0	indoor	band			
_UyfcDI_PXA	fake				
_xAOzqSpHYs	edited sound				
_z_V2_6EOso	fake				
-_m8mxxcciE	outdoor				content
-076WPWoCRE	outdoor	crowd			
-3OY-UFP2O4	outdoor	show	good	medium	
-8EUHRbTIg8	outdoor	drone			
-d7xDSENKu8	indoor	band			
-dByD-uiW-M	outdoor	ambient, traffic	good	medium	
-f-xFC58I0g	fake				
-fn4r85qrBM	fake				
-fZl02cVTBg	indoor	band			
-grgdZonjgw	edited sound				
-N9pWAK98w0	fake				
-QrPW-i44_M	outdoor	motorcycle			
-SbZ4_ir148	indoor	theme park			
-TACfxftygU	fake				
-ttwU61M-t0	edited sound				
0_FbaigWRaM	outdoor	ambient	good		
00yLU7AnGPI	outdoor	no audio			
02qeerd5YW8	edited sound				
03UPyfDYf4g	indoor	band	good	hard	
0Bvx8-kdVrk	edited sound				
0cfJOmUaNNI	outdoor	talking	good	medium	
0DhWUtlWcA0	outdoor	talking, ambient	good	medium	
0kVtC4NEPPQ	edited sound				
0m16ZWte_Q0	edited sound	talking	cuts		yes
0mcohdpEMd0	outdoor	ambient, talking, motor	good		
0rEhVAOO7EQ	indoor	talking	good	easy	
0suxwissusc	outdoor	talking, water	good		
0vg5Cfclff0	outdoor	ambient			windy
0wKRdpFd8Wo	outdoor	ambient, crowd			
0XZQV4MUd_E	fake				
0Y4-lyM7TAA	bad ambix				
0zcuZ-Rmgi4	indoor	talking	good	medium	
0Zgz2TVXJos	indoor	band		hard	
12LtBnEBhNA	outdoor	ambient		hard	
12VWE7xQuQQ	outdoor	talking	good	medium	
14_v-iyJYBg	fake				
15GEIfKyBVw	edited sound				
16dhZkQvzc4	outdoor	ambient			
19s6r7e1FuE	indoor	band		hard	
1An41lDIJ6Q	indoor	band		hard	
1D7rcZ0vwVc	outdoor	ambient, talking	good	medium	
1GR15BdheLM	indoor	band			
1IGLtJjDliI	outdoor	ambient, crowd			
1j99sWYkBCQ	indoor	band	good	hard	
1LM84FSzW0g	outdoor	talking	good	hard	
1lYoUTPuqGQ	edited sound	talking			
1pzqaZN3doE	outdoor	ambient, traffic	good	medium	
1Q_-F7amzC4	fake				
1q_0-9To33g	fake				
1QjBTvGmGVY	indoor	water	good	easy	
1T25AgTIF9w	outdoor	plane			
1WfjmkXkwQw	outdoor	crowds, nature, ambient			
22kR2g5KWYA	outdoor	skate	good	medium	
24Ow_pC_PPs	outdoor	no audio			
2A1vnPbgFPo	indoor	band			
2d-3lo5BVVY	outdoor	water	good	medium	
2d7-VONA2C8	indoor	band		hard	
2EaicpJ0vYk	outdoor	ambient		hard	
2hnHhMPJoiw	indoor	talking	good	easy	
2nKTVzDBNRM	fake				
2Nze37OTkN8	outdoor	motor			
2U4yqx-kaP8	bad ambix				
2utIgtyTYJ0	edited sound				
2VlBZuzLrnU	outdoor	water, ambient	good	medium	
2w2OJqy1igY	indoor	ambient, talking	good	medium	
2wthcGQyEf4	outdoor	water, ambient	good	medium	
2y6ZX97t5Yk	edited sound	talking			
2YTzoWLAzA4	indoor	talking	good	easy	
2zRzz0EmUao	edited sound				
2zS9cNCHzd4	outdoor	fireworks	good	easy	
2ZSXkp4tVSc	edited sound				
3_ZmNI9INvc	edited sound				
30vx8_N9Pmc	outdoor				
34SrUqQM9t0	fake				
359qEKqEMxw	outdoor	water	good	easy	
3CoutFs_vLM	outdoor	drone			
3DMhSnlf3Oo	outdoor	motor	good		
3DtKU35khmo	outdoor	motor	good	hard	
3EXa2TXAxpY	fake				
3G3atDjt6YI	indoor	band			
3ghcG_16S7c	outdoor	ambient, cars	good	medium	
-3GumCmyAIk	indoor	band		hard	
3jMW3SFiiiY	fake				
3lWh6RXQ23U	fake				
3mGHnyUIZQ8	edited sound				
3n0JIuX9fZA	indoor	band			
3V15IB3pc94	fake				
3Wt0KCsx8jI	indoor	band			
3x5ClmTCUzI	fake				
3X758yC-ouE	indoor	talking	good	easy	
3xPNuCtNx-s	outdoor	ambient, talking	good	hard	
3zCfkYnFfmM	fake				
4-EIYY8t7Pc	fake				
4-VI6wHytIk	indoor	music	okay	medium	
470UIL-CvjU	fake				
48XXKW4A69g	fake				
4EAmFGIf6Bg	outdoor	fireworks			
4EgRaySMjJQ	indoor	band			
4f1SradYz88	fake				
4fxKBGthpaw	indoor	band			
4gCK4G5zcLw	outdoor	ambient	good	hard	
4H0sn7S7y4A	indoor	band	good		
4hb9gnKnyCs	indoor	band			
4HKi28AHdpY	fake				
4itJOgIKbU4	outdoor				
4krs7z2bjlE	indoor	band			
4LlfpNyZ0z4	indoor	band	good		
4mAa-hXNV5Q	outdoor	crowd, motor			
4OI0NyIoGyw	outdoor	water	good	easy	
4OjImrdr1ZU	indoor	talking	good	medium	
4pdZ5OpMAjQ	indoor	band			
4QDHvxUkzxE	outdoor	motor		hard	
4QhoGDH_fBk	fake				
4rC735MTMwo	edited sound				
4rcoX9lon34	indoor	band			
4SvPjNlF01E	indoor	talking			
4VtEg4wANeQ	fake				
4XTKwHj1sSQ	edited sound				
50jWYPiXyz4	outdoor	ambient, walking	good	easy	
52GLxs-0W7A	fake				
53bFpbHd8SA	fake				
5BYg9fJ0YyQ	edited sound				
5DtlAyQxLY0	edited sound				
5g6NIa-ZTxg	indoor	band			
5G7dCiq1owE	outdoor	ambient		hard	
5GL3P_3ehQI	bad ambix				
5grobANTyX8	outdoor	ambient		hard	
5H2Zfy7ciRw	edited sound	talking			
5h95uTtPeck	indoor	talking	good	easy	
5haruMX5-PQ	indoor	band		hard	
5HidVCdd76o	edited sound	band			
5I1L6dQv1CM	fake				
5jNAMtcSLhQ	indoor	band			
5K3JaGCrDtg	indoor	band			
5M8qir0gNIA	outdoor	band			
5mg-xwG0d_Y	outdoor	motorcycle		hard	
5OLOsYRhNEM	indoor	piano	good	medium	
5QA02eQ-JZI	edited sound				
5RYN-TL1ylM	fake				
5SsS_--dwiw	fake				
5v3LY8FXgf0	fake				
5w6jVK6HmIs	edited sound				
604yJY6pHgs	indoor	band			
63O_ftOI_aQ	bad ambix				
652iPIP3pHk	fake				
66aDKj34l04	outdoor	street	good	medium	
687gkvLi5kI	indoor	band			
69Aw5PC1h4Y	outdoor	music	good	medium	
6BJorrGulVs	indoor	band			
6dva-9_c-KM	fake				
6H4XFu5_YxM	edited sound				
6HagQNmWqok	outdoor	ambient, cars	okay, cuts	hard	
6HLslXkY784	fake				
6IXgAmerkTA	indoor	band			
6JTKEOAWLyQ	outdoor	music, ambient	good	medium	
6MYOMLCTlK4	fake				
6nHewn2LrV0	outdoor	ambient			
6QjeUtYDggA	edited sound				
6QUCaLvQ_3I	indoor	band			
6r1jZfDxe4g	fake				
6t50Md7CICM	indoor	crowd	good	hard	
6TRDPUkrM-c	fake				
6uYRW0FgZpo	outdoor	ambient, nature, talking	good		
6VPtrPlRWE4	outdoor	underwater			
700Gkaf1ZXA	outdoor	band			
72f3ayGhMEA	outdoor	talking, car	okay, cuts	hard	
74ZiZ1iGG4k	outdoor	ambient	okay, cuts	hard	
78wfVeTDbLg	outdoor	motor			
79krTgvzw6c	fake				
7aY4qUF0DIo	outdoor	motor		hard	
7CayA9TOa7M	outdoor	ambient, vehicles	good		
7dLGdZOWYOE	outdoor	talking	good	medium	
7EZfEHmk-hM	edited sound				
7gxHJtyeZpA	outdoor	ambient, music	good	medium	
7H4TcuThyX8	indoor	band	good		
7jiN9hsm-kQ	indoor	band			
7nyEhYNnBXg	indoor	band			
7nyl46ZM8zQ	indoor	talking	good	easy	
7Pa33AYjvlI	outdoor	motor, ambient	good, cuts	medium	
7Q0_uzArNaU	outdoor	motor, ambient	okay, probably too much noise from the bike the camera is sitting on	medium	
7RCWTTfzOzY	edited sound				
89eg3nExUI4	indoor	band			
8dM530Cl0sE	edited sound				
8i_-l_AXP1M	fake				
8Il25i4IgSc	fake				
8JALs25KRtI	edited sound				
8vIsfkzDY0Q	outdoor	ambient, nature			
93V0rQ6L0iQ	indoor	band			
93V0rQ6L0iQ	indoor	band			
99-QpwKXh-o	fake				
9A6z42uZLvo	repeat				
9Ab9TWtqCv4	indoor	band		hard	
9FK9qU7ccCY	outdoor	motor	good	medium	
9fzOqxzLfd8	outdoor	bells, street			
9L5G0a0GfDw	indoor	band, violin	good	easy	
9OJDmis_dM8	outdoor	ambient	good		
9OJDmis_dM8	outdoor	crowd			
9rfuCjVU1jk	indoor	band			
9UOpRjrFPIg	outdoor	motor, wind			
a_I8JqLpEUc	fake				
a5oH6pj_jsI	fake				
A9n67yCpkx4	indoor	talking, music	good	easy	
abVkfxLrB-U	edited sound				
aca25zxviIs	outdoor	ambient			
aFf3lDOAp6Y	outdoor	in action sport			
aGjZtESesOI	outdoor	traffic	good		
aHNpIvEqJXk	edited sound				
aI1CRiiG2VM	edited sound				
aKRMhMOHs8I	indoor	music	good	hard	music
AKwr1WaWumw	outdoor	ambient	good	hard	
ANiYqjx9r3U	indoor	talking	good	easy	
aofRlMo7v70	outdoor	driving			
AOoAXwJ-DG0	indoor	band			
apsKEVqaNwU	edited sound				
arEX6Uo-0cc	outdoor	walking, driving	good	medium	
aRGmAZVl80E	fake		seems fake, or at least very bad sound quality		
ATsKN7HVbUg	outdoor	ambeint, water	good		
aVu_bZFLtCc	outdoor	ambient	good	medium	
AZb-6EYDIVs	outdoor	talking, nature			
B60Ghs1BW6Y	deleted				
B60Ghs1BW6Y	deleted				
B7el-TvTuBI	outdoor	crowd	good	hard	
BAgStSY6mIo	indoor	music	good	easy	
BbKFi2u0yYQ	outdoor	street, traffic	good		
Bbs0Cuy_ozU	edited sound				
bCjt8o3migE	indoor	talking	good	easy	check spatialization
bD9bDhWUf2c	fake				
BepbaX-UuR0	fake				
bGnivk-jepU	outdoor	street, ambient, traffic	good	medium	
BhC9mSvXcAI	edited sound	ambient	cuts	hard	
BKJHKXHS9n8	fake				
BkYEfncGw40	outdoor	drone			
Blhh7qtgl-8	outdoor	ambient, crowd, water	good	hard	
Bo2EVMu8c6E	edited sound				
bO43msZTfwA	outdoor	band			
BocUY7ALy7w	outdoor	talking	good	easy	
BpQY-SKlS8U	edited sound				
Bu0o0jpS1kU	edited sound				
Bw0offlncsE	indoor	band			
bxnrry6ufRQ	indoor	talking	good	easy	
c_XLrDQeSKI	indoor	band			
ca3jnvrE0fA	edited sound	voiceover			no visually indicated sounds
Cc2ZRk2aLFw	outdoor	wind, cycling			
CCHqaKfm96A	bad ambix				
CCPB8aG41OI	outdoor	skydiving, wind			
cda50MG0hKA	fake				
CEA_q7cKgMI	outdoor	plane			
CHOelflV6A8	outdoor	drone			
Ci2Xmro56Lw	outdoor				
cIxqEIJuFok	outdoor	band			
cmqlH9jFzNw	fake				
Cp6jKrNQqvE	fake				
CQugYR1Dvvc	repeat				
CREpRoomofw	outdoor	band			
CRqP3VFrars	outdoor	street, crowd	good		
CuGCyjT12HM	outdoor	band			
cvHmTfMbM8U	outdoor	wind noise			
cVR2dXNo_fw	indoor	talking, movie	good	hard	edited, but might work
Cy1RcEmhJS4	edited sound				
Cy9z9vl1o5k	edited sound				
CYiKu-303ho	indoor	band, sax	good	easy	
cZrtEdOIONA	outdoor	talking	good	easy	
d_EYuZOscuc	fake	car	cgi		
d--5uWUXhPM	outdoor	ambient, talking	sources to small on image	hard	
D0uOTa8i1B0	bad ambix				
d39VDe5SiYU	outdoor	croud, fireworks	good (for fireworks)	hard	
D3atMXKFCY8	edited sound				
d8HGtQYOD9Y	outdoor	ambient			
daZ2ffvJ5CY	outdoor	ambient, water	good	medium	
Db-uq08ydI4	outdoor	nature, gorillas	cuts	easy	
dBM3eM9HOoA	indoor	band		hard	
dd39herpgXA	outdoor	ambient	good	hard	
dDwlYHRlmn0	indoor	talking	good	easy	
DhC780htXOc	indoor	band		hard	
Di3FaSDxSRA	outdoor	crwod, music			
dJ1MDncClAI	fake				
DjYIyLX-aSk	indoor	singing	good	easy	
DkjlrTE5lD8	outdoor	ambient	multiple outdoors videos		
dKXcVq61y8Q	outdoor	band	good	medium	
DlGCaTuyvmk	outdoor	park, ambient	good	medium	
dloBiZdmgHw	fake				
dlS3vQEBkYU	outdoor	motor, ambient	good	medium	
DmUeqcBI3oo	fake				
Do6STjKPJPQ	edited sound		cuts		
dOitixD0pUk	fake				
DowG7clEJuA	outdoor	band		hard	
dpcAENP603k	indoor	band		hard	
dpfkpZzZvqw	outdoor	vehicle, wind			
DQHOZC7ZiD8	outdoor	ambient, water		medium	
DqlUEiyku44	edited sound		cuts		
dQZn3cqvJes	outdoor	ambient	cuts	hard	
DrFIla_GVvY	edited sound				
drWeRm7OYmc	edited sound				
dS7Ffvs2Evg	outdoor	traffic	good 	easy	
dT_XlgRkTKo	outdoor	music	animated	medium	
duJxAVJzQ4g	outdoor	ambient			
DvbR51WJFHA	indoor	band			
DvKgcBbvGa0	outdoor	drone, wind			
DVnx4873bg0	fake				
dw8FWzSxl7o	indoor	band		hard	
DwF_sNb2tsE	outdoor	water	good	medium	
DxpKP5PmR94	repeat				
DYHKh-qqUGI	bad ambix				
dySedWOZ9CE	indoor	band			
E-b5PMsLjmE	fake				
e0gbKSHtH24	indoor	band			
e13IklbYpp0	indoor	band	good	easy	
E1fkU0g4wk0	indoor	ambient, theme park		hard	
E2h4a4pLC4A	indoor	orchestra			
E2jWVn7MgvA	outdoor	outdoor, motor		medium	
e4q1j1a44Zs	indoor	band			
e54PVEpDoCU	edited sound	ambient	cuts		
e54PVEpDoCU	edited sound				
e54PVEpDoCU	edited sound				
E8WpGZxPlFE	outdoor	ambient	good	easy	
eauS5cwJmNc	fake				static image
eCsKEbs6Ink	fake	ambient			
EczTf_oTZjo	deleted				
eDDmstlwW24	indoor	band			
efiv1KqRD5o	fake				
EFNxuXvqQYA	outdoor	band	too noisy		
Eg_SGvYgNp0	indoor	band			
ek5aFRaRxxE	outdoor	water, ambient	good		
el7kwS4yzBw	indoor	talking	good	medium	
ElPiRfIXXOg	indoor	band			
eNRPjcjAsaI	outdoor	motor		hard	
EobzaJc1_ts	fake				no visually indicated sounds
Eojj8gAvebU	indoor	talking	good	easy	
EpSMtJmZ28M	outdoor				
eQOtHjxYHg4	fake				
Er6BDsQ9VCg	indoor	band		hard	
ERrPTlyetO4	indoor	band			
eSY6O4CMfBU	edited sound	talking	cuts		
etAXe5y_Ek0	fake				no visually indicated sounds
eu0hu1VTZBc	outdoor	ambient	good	medium	
EVCsSf-OrNI	outdoor	ambient, traffic	good		
eVllqiMUH3U	outdoor	motor, traffic			
eXe7-021dfs	fake				no visually indicated sounds
eXkcfLt2LXc	outdoor	water	good	easy	
eY9DMn8pgGA	fake				
eZwSPN27bfo	fake				
f4WN5Q9x5JU	outdoor	talking	good	medium	
f5YQ1lA3kQI	outdoor	cutting wood	good	easy	
f6NmIiLfg3Q	edited sound				
f6T9m9eKMpg	outdoor	ambient, talking	distant sources	hard	
f76ieXdWX7Q	fake				
f7jVCcfZeKs	edited sound	water, music, people	cuts		
f7zy6zkNKqE	deleted				
f9YTQZE8Ve0	indoor	talking	noisy	medium	
FAeSKakzkGk	outdoor	talking, airplane		medium	
fcEK7peBYPo	edited sound				
fcMnG-RGhuQ	fake				
fEczdIzlUFo	edited sound				
fEL--DG8Bas	bad ambix				
fEPDPTxbtko	edited sound	talking	noisy	hard	
fEPDPTxbtko	edited sound				
FFmvv8HUYPw	indoor	band			
fFrtCjkSvHI	outdoor	band			
fFsL5Q3hbwU	indoor	music		medium	
ffsznHClegw	indoor	band	bad quality, some instruments are amped so not sure if they will be spatialized correctly	hard	
Fhf_vI_iCZM	fake				
fJfHio68IrU	indoor	band	camera not located in space spot as mic	hard	did not seem spatialized when I moved around
fkELQyDb6T0	fake				
fl-rc2-fb4Y	indoor	singers	10 singers at once		
fM1uAG3MdnU	outdoor	music	good	medium	
fMAN_Lwqq1E	fake				
fNVoFSg4LDQ	outdoor	talking, noise	good	hard	
fORNZZkQVFc	edited sound				
fPLEyQzgHQc	fake				
Fps2ato1-p4	indoor	band			
frCYUlIw3Oc	fake				
fRMTS_8pJv4	outdoor	car race	camera sitting on car making noise	hard	
fryDy9YcbI4	fake				
FuU0gphmHYQ	outdoor	helicopter	motion everywhere	hard	
fWcDkbETJTU	outdoor	crowd	lots of people	hard	
fwe03itaoeM	indoor	talking	good		
FWpruxd6WEM	fake				
fXbsp1ik85k	indoor	talking			can't see sound source
FXZP8850kh4	indoor	ambient	good	easy	
fYxFTRiFBKQ	edited sound				
G-XZhKqQAHU	fake				
g1ruGyRj2BU	indoor	talking	good	easy	
g4fQ5iOVzsI	indoor	talking	lots of people	hard	
G72TxAMi-AE	fake				
g8OuAMlD6Sk	bad ambix				
G8pABGosD38	outdoor	traffic	good		
G9U4n7c9C88	fake				
GazqCSHqxuw	outdoor	ambient	good		
gbHirG61jaA	fake				
GDUbLW9qClA	indoor	talking	good		
gh5_RhAMa0c	fake				
GivY6W4VBxY	indoor	talking	good	easy	
gjwO1St4p9E	fake				
gkh4yW3WVn0	outdoor	band			
GKOf3aC0kEk	fake				
gkvcRyAmW1M	indoor	band			
Gleb5jsH3_A	outdoor	talking	good, multiple scenes	medium	
GnEWtqSidOc	outdoor	talking	good		
Gnwhcfqv6ZE	edited sound				
gnXzPlRdQBg	outdoor	crowd, ambient, traffic	good		
Go2AW0qoYsU	fake				
Gotc4Ios1l0	outdoor	talking	good, multiple scenes	medium	
GPmKQ0wVGfk	indoor	talking	good	easy	
Gq4Y4gL3zSg	indoor	talking	good		
GR60RiycSW8	outdoor	ambient, park			
GSPH3rKdgVc	edited sound				
gSueCRQO_5g	outdoor	skating	good	medium	
gtfCS70G2tE	edited sound				
gtIF8lJOOPE	fake				
Gvhi8TaIJGw	fake				
gw5iqwdgWdM	indoor	band			
GW6ZBTGY2DQ	fake				
gWHi3LlvC3w	edited sound				
GWKQPptXEL8	fake				
gY-hsal7d1Q	fake				
GYDzBrihZ4g	outdoor	ambient, street	good	medium	
GyiujGdjdq4	outdoor	music	good	medium	
H0Bk-XECT4o	indoor	band			
H0W5vTi1coI	fake				
H1QOF1WieSk	outdoor	ambient, talking	good	hard	
H2EB1Vn0O8Y	fake				
H5I_AoL_dqw	fake				
h6BNmvrPx2Y	indoor	band		hard	
H9dyr9OXNaM	outdoor	ambient			
HaCPhXb4C9o	indoor	band		hard	
Haj-Fy4DxqE	deleted				
HaqthAVqg7g	fake				
HBEKcPJPTIM	indoor	band	good	easy	
hdp-V6qUd8Q	edited sound				
HemwKBjQ0Uc	fake				
HFYwLMqm9oA	outdoor	talkng	good	easy	
hGbuGQgrp6I	outdoor	crowd			
hiFt8CnzWmc	indoor	crowd			
hkxP59NO6Sk	edited sound				
hLr1SWmwh08	fake				
HLWecQCxqU8	fake				
hLY_QGrxekI	indoor	band		hard	
hmLDe6H50tI	outdoor	ambient, talking, train	good	medium	
hnD5P_eDTWI	outdoor	ambient, plane			
HNQMF7e6IL0	outdoor	ambient, talking	good	medium	
Ho_9b4TZ4mY	outdoor	ambient, talking, steps	good	medium	
hoq-uokv1eY	bad ambix				
HQ8HIh4TiLs	outdoor	ambient, 			
hQpA12LhR-k	outdoor	wind, vehicles	good	hard	
hR1mNJ11ycU	outdoor	ambient, talking		hard	
HSwFTK1ToaI	outdoor	ambient, talking	good		
ht6-XcZV1IU	indoor	band		hard	
huHiPwrSrCQ	deleted				
huHKiryg5UU	outdoor	ambient	good	medium	
HUIwQlw5_XA	indoor	band		hard	
HUIwQlw5_XA	indoor	band			
HuLD49WoG1E	fake				
HuLD49WoG1E	fake				
HUZTBwuu7eY	indoor	band			
Hvu6e5y0ZNU	fake				
Hvu6e5y0ZNU	fake				
HwZ1kOGiCZU	indoor	theme park		hard	
HwZ1kOGiCZU	fake				
Hx7e2zmRMgY	edited sound				
Hx7e2zmRMgY	fake				
HxbZV0cmLaw	fake				
HxbZV0cmLaw	fake				
HyrylinoxqI	outdoor	ambient, talking, train			
HyrylinoxqI	indoor	talking,traffic	good	hard	
Hz4VMAUswbQ	edited sound				
Hz4VMAUswbQ	outdoor	band			
hZxgNHiQbj0	repeat				
i_pVzEpleW8	fake				
i_pVzEpleW8	fake				
I-43DzvhxX8	outdoor	ambient, talking	good	medium	
I-J0BIO4hHE	outdoor	ambient, vehicles	good	medium	
I-J0BIO4hHE	outdoor	ambient, traffic	good		
i-OFj3B0Yms	outdoor	ambient, vehicles	good	medium	
i-OFj3B0Yms	outdoor	ambient, traffic	good		
i0fn2-80odc	fake				
i0fn2-80odc	fake				
I1_27fwyRZU	fake				
i3TjIiaKDVU	fake				
i3TjIiaKDVU	fake				
I6EHQIQ_StU	outdoor	in action sport			
iAh21TDFXzQ	edited sound				
iAh21TDFXzQ	edited sound				
iaiXZG4YJb8	outdoor	ambient	good	medium	
iClx1zbUWxo	fake				
iClx1zbUWxo	fake				
IDRG2CJIAbM	outdoor	in action sport			
iEDRuJWGhZ4	edited sound				
iEDRuJWGhZ4	edited sound				
iHi64dMEsPc	indoor	band, orchestra			
IHKStNPCy3M	indoor	band			
iIjjoz1ejaw	outdoor	ambient, talking	good	easy	
iIjjoz1ejaw	outdoor	talking	good		
ikkXVRhmXsg	outdoor	water	good	easy	
IkNuACk4tEI	deleted				
iMHBCQYyxTY	outdoor	motor			
inAOOZehp1c	fake				
inAOOZehp1c	fake				
IpCx0Z8uTeA	repeat				
IQ7y1GrbrXc	outdoor	ambient, talking, moto	good	medium	
IQ7y1GrbrXc	outdoor	ambient, talking, traffic	good		
IQAgJ_farVk	outdoor	ambient	good	medium	
IRF43yEkFOM	outdoor	band			
IRMUptj1MH4	fake				
IRZpGA5n74Y	bad ambix				
iS_-xMudbZI	edited sound				
IsQ7LWDUY9o	outdoor	talking	good		
itWJ221IBrU	edited sound				
iuDjDtPjpVc	outdoor	drone			
iUJ58nA_Tm4	edited sound				
IuN5joAWuqk	outdoor	band			
iVPZpOP1YSU	fake				
iVqMLVbcf1s	fake				
IVRIMGqqp2g	indoor	talking	good		
iWOdtR4clKE	outdoor	ambient			
IwOIvqmxe7M	outdoor	water	good		
iWpuOrmm2Zo	indoor	band			
Ix5-Ih38tFE	edited sound				
IywSTYwIUHE	outdoor	water	good	hard	
J_fEQLEgvlY	indoor	band			
j0ffyhYQcM8	indoor	talking	good	easy	
J0Q4L68o3xE	indoor	talking	good		
j1XplAu2dwA	fake				
J2PYwi8fy-M	indoor	music	good		
J2PYwi8fy-M	indoor	music	good		
J2PYwi8fy-M	indoor	band, violin	good	easy	
j3JfxVPZTjo	fake				
J3n8j07skhM	indoor	band	good		
j57BZrvKtog	outdoor	street, crowd			
J5u-r9KzQZ0	outdoor	street, 			
j5ZJtiQtL_o	outdoor	no audio			
j7Hj9C2Y4Lw	fake				
JA7uN2ygPfk	outdoor	talking	good	easy	
jb5YxiXIsjU	indoor	talking	good		
JBrp8aG4lro	indoor	talking	good	easy	
JbZgoiXxzIk	edited sound				
Jd1_DTe9ibE	fake				
JDAnDzXAVDs	indoor	band			
JDdn2qp-a_Y	outdoor	ambient, water			
JEbPgn3clPk	outdoor	traffic			
JeC4MBMoqf0	edited sound	music			
JfwwWCUzes4	indoor	talking	good	hard	
JG7Z7cQm4a8	outdoor	ambient	good		
jIxQXGTl_mo	fake				
JJ-r49OXaPU	outdoor	music	good	medium	
jjFB8jUvEno	indoor	band	good		
JjOCViuhKwo	indoor	band			
JJr_peu2Rpk	fake				
jkC3mabtAC8	edited sound				
JKd6UKLF9s4	edited sound				
jKPvpVBECQ4	outdoor	ambient	good	medium	
jL39PuZmfPk	indoor	band			
JlbvYIcLGIo	fake				
jLrVY7LV3Lc	outdoor	talking ambient	good	medium	
jmEu_f0ccCM	indoor	band			
jMMcnEHtpDs	indoor	band			
jnopGSHnOXc	indoor	talking	good		
JOpvhgy0i6o	outdoor	talking	good		
JpbIfHvgF_o	indoor	band			
JptTJ2Ow5GE	indoor	band			
jrvEjtkpIPM	outdoor	talking	good		
jrvzuQmr5to	outdoor	bike	good	easy	
js-sWf2lBfc	indoor	skate	good		
Jsj9obKqpAo	indoor	band			
JVKiuDDzKLw	indoor	music	good		
Jwl6W9NO4a8	outdoor	ambient, talking	good		
Jx8aWIt5oGM	indoor	band			
JXbGskXdAVc	outdoor	traffic			
jxo61NUNF1M	edited sound				
jXZr8aoD3vA	indoor	band	good	medium	
jZcVli4sde4	outdoor	ambient			
K-1cT1nTMa0	fake				
K-WZrwe4SN0	indoor	band			
K1iopRkaevE	fake				
k2xpqOhZteA	bad ambix				
k4F0U2pFpzM	indoor	band			
k4F0U2pFpzM	indoor	band			
k4F0U2pFpzM	indoor	band			
k8gpZL3RZ3A	outdoor	ambient			
kawi0NpcrjY	deleted				
KayHKHkYMro	indoor	music			
KbUrk86xsxw	outdoor	band			
kdiw9UubQdU	edited sound				
kDqR0jLZ8Jk	indoor	band			
kEQudO4eDjY	repeat				
KFBk21Mb8G4	indoor	talking	good	easy	
kFYHteKyvkU	outdoor	vehicle			
kG_Ubv_5OFY	fake				
KgAitrNrkBo	fake				
KGpAJAwRqgA	outdoor	crowd	good	hard	
KhUBHYNoY4Y	edited sound				
KhyzFALXw_4	fake				
Kj-RSMFFEZ0	outdoor	ambient, water	good		
KK6k6F7WkOg	edited sound				
KkPkXrbjf4g	indoor	band			
kleIDLBaRiQ	fake				
KN7eBXl1jeE	outdoor	crowd	good	hard	
KnC6LrKDn4A	edited sound				
knOkKqZm6I4	indoor	talking	good		
Ko9pZC8u5v8	indoor	talking	good		
KowG8Iur63M	indoor	talking, vehicle			
kPssHl1FXTY	indoor	band			
KpwPf42QGbI	outdoor	cycling, wind			
KrEHdKxlNDQ	fake				
KsgHpe-PPWs	fake				
KsxY0QCC5vk	outdoor	ambient	good, multiple scenes	hard	
ktG8M-Cyyck	fake				
KuCYGSYh5AE	indoor	band			
KVAFzxDuEPE	outdoor	ambient			
KvSsYaoSJGI	outdoor	ambient, cars	good	medium	
kW1e7Mpzp0Y	edited sound				
KYqp3UjczeA	indoor	band			
KZEZPlrFMSg	indoor	band			
kzoJcdVVG_I	indoor				content
kzWozTWdlLY	outdoor	ambient, motor	good		
l-Ve9Vwj3gw	outdoor	ambient, beach	good		
l0_YOXuUv3o	outdoor	ambient			
l0qDAG7jGfg	indoor	band			
l2bSP81yuEU	indoor	live performance			
L2Tv5v__9m4	edited sound				
l3lV9SfiRMs	fake				
L4d4MGZaU5k	outdoor	drone			
l5LmPyrHWtY	deleted				
L8cauhX5_xY	fake				
LBUr14xs9k4	indoor	live performance			
LbYQ_WXyL64	edited sound				
LDBWBUVZsCI	indoor	band	good		
ldxaKDWb_Kw	outdoor	people		hard	
lExGTaNEzoM	outdoor	traffic	good	medium	
LgtoCpjwWdg	edited sound				
LIQ-UJ3OF18	deleted				
Lk7JHCLlQdQ	outdoor	ambient			
lKDQtmclsOE	fake				
lLIFe9-4060	indoor	band	good		
LlQtD_7Rb4M	edited sound				
LNgvYxuCdo0	repeat				
lO0NGCXKs2k	fake				
lR6sTaXYCoE	deleted				
LrRh2IJUoZg	indoor	band			
LSeJeKHsUkw	outdoor	band			
lSjtXJf6Blg	outdoor	ambient, motor			
LThm7VYvwxY	outdoor	ambient			
lveuF34ho4M	indoor	band			
lYucM0BW-lo	outdoor	ambient, motor	good		
LZ_ds4CAycc	fake				
m-33Po69EeY	fake				
m-YsMLUaYg4	edited sound				
M0b_7poS6Jo	outdoor				
m492YyGMNyQ	outdoor	motor			
m4KnpIUjHJ4	indoor	talking	good	medium	
m5HLgeCrW20	fake				
M6-z12K9bhs	edited sound				
M6C6yWylLc8	indoor	band			
M6C6yWylLc8	indoor	band			
M6C6yWylLc8	indoor	band, orchestra			
M9eBQZhHD8k	outdoor	in action sport, talking	good		
maEpS6M4GWo	outdoor	crowd	good		
mBPqc35yH7I	indoor	band			
mbvoylDx_Qo	fake				
mCev-M_-3tU	indoor	band			
mcwP16h2rF4	edited sound				
MDwhMMSFkJ8	indoor	band			
mekadE8PLgk	indoor	band, guitar	good	easy	
MEpcdndagh4	deleted				
MezeLUxexP0	outdoor	crowd, music			
MgbRXF5DCFw	outdoor	talking			
mGsVk0GTGmM	repeat				
mHC_numQNKc	outdoor	ambient, crowded			
MhEi91b6ako	indoor	band	good		
Mhhor5du92g	fake				
mhZcVjNdwzE	outdoor	jumping	good	medium	multiple videos could be split
MiaETmJ7atc	outdoor				
MIeLzNrlc4Q	fake				
MihCJVXBNJw	edited sound				
miL-qUw3S9U	indoor	band			
MisoxQQuHGg	outdoor	street, crowd			
mJWodsZclP4	fake				
mkaBzkslLdU	indoor	band			
mkaBzkslLdU	indoor	band			
mkaBzkslLdU	indoor	band			
mKCVjnlgOEQ	indoor	band			
ml7_yeHfbP4	outdoor	ambeint, motor, talking			
MNCrIYHnamA	fake				
mnQewl4gld0	repeat				
MNqKH1ctnLU	deleted				
mOAFJQbBBaA	outdoor	ambient, water			
MovSNaJPgaE	fake				
mQJKL78jkpY	edited sound				
mqz_faUPe28	fake				
MSIyd-HKDps	outdoor	ambient	good	medium	
mtxCV7jPC40	fake				
MUbzi_09KXU	fake				
mUmneTwv8YU	outdoor	talking, ambient	good	medium	switches mics
MUu9GhNfP0s	edited sound				
MVkbQpYm3rg	edited sound				
MVV0iv9Hp84	deleted				
mw7LD4BojlE	fake				
MWMziwEXxvc	indoor	band			
MXqywNqhPT0	repeat				
mXXTaoZ7vTw	fake				
MYmMZxmSc1U	indoor	ambient, talking			
MZ7dKdTHbqY	indoor	talking	good		
MzcdEI-tSUc	indoor	talking, ambient	good, multiple scenes		
MZO7Mps-vJk	edited sound				
N-e4qGIbA7g	indoor	band			
N-Xzyndd3K8	edited sound				
n0PvJiIn6kM	outdoor	talking, crowd	good	hard	
n4niMm2CjpM	fake				
n4qs1ASbGx4	fake				
n524y8uPUaU	outdoor	driving, talking	good	medium	
n6-hK0ege5c	repeat				
n7N1KAECOUA	indoor	band			
N9cLS3lfGsE	fake				
n9JX1gUnJg4	indoor	band			
NdE7uYVaynQ	outdoor	ambient, performance	good		
nDktP8Ny4Mk	bad ambix				
nDu57CGqbLM	outdoor	animal	good	easy	
neef_gJdaYk	outdoor	ambient	good		
neef_gJdaYk	outdoor	ambient, crowd			
neef_gJdaYk	outdoor	street, talking			
NInS4kaZ-rE	bad ambix				
NJzzEEG6FZc	outdoor	concert			
NL9NRyKo5KA	outdoor	ambient	good	hard	
NlVipwFzI7I	outdoor				
nmtoUkaIxiU	fake				
NNhN2Y6ZVkQ	indoor	talking	good		
NO7pCD9HcOU	edited sound				
nOoWRhp9ZiA	outdoor	talking, ambient	good	medium	
NPIXL3aas-8	outdoor	talking, music	good	hard	
NqI77hrV8Ks	bad ambix				
nR3j_Mx-0n4	outdoor	talking	good		
nR3j_Mx-0n4	outdoor	ambient, talking			
nR3j_Mx-0n4	outdoor	talking, ambient	good		
NrixRrRLKtA	fake				
NsDYV9ZQjbI	edited sound				
NtkRZ1MFY2s	fake				
nToc_9esuCU	deleted				
Nu3Aub9ifes	indoor	talking	good	easy	
NUIpYejiDt8	outdoor	ambient			
Nxe80smr9xM	outdoor	crowd	good	hard	
NyoGIdJOatE	outdoor	talking	good		
nz3NIQE_gsA	fake				
NzfE5EllJcY	indoor	band			
nZJGt3ZVg3g	outdoor	tennis			
o-CVRqYSexI	edited sound				
o0HeIILbU_o	fake				
o0HtrISbIQI	fake				
O1tbUAHVvTU	outdoor	vehicle			
o7JEBWV4CmY	outdoor	ambient, talking	good	medium	
OB_YQZZvX-I	outdoor	ambient, water			
oB1up7vRN3Y	repeat				
ObgKGPWQQNY	outdoor	crowd, band			
ockWP6N8Pbo	fake				
OCvdL0jw4r8	fake				
OEapffs2lq0	outdoor	band			
OfMFVMG3LXA	indoor	band		hard	
OGn20SNUUmU	outdoor	band, ambient, water	good		
oIP1s8E5mF0	indoor	band, singing			
oJIo-Ouk1SY	fake				
Ol72AnHjE1o	fake				
OlQGrue044c	edited sound				
omAGGMW7JFE	indoor	car wash			
OMLgliKYqaI	indoor	band	good	easy	
ONwWgyOc7Ok	outdoor	band	good	hard	
oOc_3cZjH1I	outdoor	water			
OQ6vT4VNLUM	outdoor	ambient, talking	good	medium	
oQSndLsnLK0	fake				
ORMOlzpEl_M	fake				
OSg2zQm38Xw	fake				
Osy9YOIz5RY	edited sound				
OtwOz1GVkDg	edited sound				
OU2mkLmW5BQ	outdoor	in action sport			
oU59dAultNg	outdoor	drone			
Oue_XEKHq3g	outdoor	ambient, traffic	good		
ougLErM9tj8	edited sound				
ovjZ1-11x74	indoor	talking	good	easy	
OWN_J9FGZ5I	outdoor	ambient, talking	good	hard	
Oxa_7f372yA	bad ambix				
oxNOKsLrGC0	indoor	band			
oZhDU-SjXzg	indoor	band	good		
p0dKfplTYZg	outdoor	motor, traffic			
p0HamWCVrFI	outdoor	talking, ambient	good	hard	
p17f4ywcKJ0	fake				
P1hnjRkXrLc	outdoor	ambient			
p2HQGFwtLeI	indoor	band, choir			
p3VqmbhudOM	fake				
P4KyjvsceZQ	outdoor	talking, ambient	good	medium	
p51jhLQFkmY	fake				
PbboDe6LKpA	indoor	band, guitar			
PBxUJk7evkc	indoor	indoor talking	good		
pdxDaxTpFoY	repeat				
PEut3w_CMfg	outdoor	ambient, street	good		
PF3IuK00ujo	edited sound				
pFFGCVZM68g	edited sound		good		
PgR_YjhMNno	indoor	band	good	easy	
pHb0IPApb5s	indoor	band			
pHUVS_GrIeM	edited sound				
PJFOnPTH_Qk	indoor	band, talking			
PjiUo1JERjw	fake				
PJQNhK3FUro	edited sound				
pjy-lzuZy5I	indoor	band			
PKGDnSHbNww	fake				
pKIYx6IdSOs	edited sound				
pN38tgYMHs4	repeat				
pN8V6Sj2v1E	outdoor	ambient, walking	good		
po5rZ0EzSeE	outdoor	ambient traffic		hard	windy
pOJ_MulHQ_I	fake				
POUtDHdO3ug	fake				
PPxqM7oR1Kk	indoor	talking	good	easy	
pRaDY4sIHhU	edited sound				
prqDTwrZqyk	indoor	band			
pSZ1V4NkJJc	outdoor				
PT4sml5gXY4	outdoor	talking	good	medium	
pUc9ZS5xPaA	fake				
PuekW6d_0yE	indoor	band			
PugDAc7Uc0U	indoor	washing machine	good		
punYlPHdGiw	indoor	band			
pVBTPHjNunw	outdoor	street, traffic	good		
PVWgZKtOMjY	outdoor	band			
pXdcvLy1vVY	indoor	talking		hard	
pY-KbiDiKic	fake				
PygsKZXpYrI	edited sound				
pZe-GpDyKdw	edited sound				
q-bydXps2Zk	fake				
q0NXtY4N4Lo	indoor	band	good	easy	
q1zQOA-SslE	indoor	band	good	easy	
Q2iVM-go4_g	indoor	theme park			
q3rNT2B2fQg	indoor	band	good		
q65zGO7s3rM	outdoor	band, street	good		
QAb_124ac5k	fake				
QaL8YLg_JGI	indoor	band		medium	
QAUnJoxIjGk	fake				
QcnSIlhyRww	outdoor	ambient, waves			
qcZSxXlUa1M	fake				
qD-shAzTFsU	indoor	band			
qeGu9Dl_kcY	fake	traffic, ambiet			
QFRhVZjWe3M	fake				
qFt8t9qZTm0	outdoor	ambient, traffic	good	easy	different cuts
QiDDwDlIcos	fake				
QJ6S0dWkQjY	indoor	band		hard	
qJO0RSk4htI	outdoor	vehicles	good, multiple shots	medium	
QjRxtDXGyV8	outdoor	ambient, waves			
qk9xX1xPbr4	indoor	radio			
qKhRp6NA32U	fake				
qliVdl8NQVQ	outdoor	talking, ambient	good	medium	
QmmPrK4ovoU	fake				
QndAZPPuz-o	edited sound				
qOyFqDW6jro	fake				
QpDblC4VoDA	outdoor	ambient	good	hard	
QpiDdIuHEFw	fake				
QpyR-OpaQ_c	edited sound				
QQ9l3WrNsNk	fake				
qqj5g-kjyl0	outdoor	fireworks	good	medium	
QQTlq72pqSA	indoor	band			
qRBDAwgpLs0	indoor	band			
qRj6ap0ZjGA	indoor	band, orchestra		hard	
qrMkehSkblk	indoor	band		medium	
QTFZSp-_o1w	outdoor	ambient, nature	good		
Qtpl2YJPvJY	repeat				
qUTNqWWIF0k	indoor	music			
qvhWgJeerRo	fake				
qYb8BbiLeUg	fake				
QzdtNdF9yVc	indoor	band			
r_uAkMkSsRo	outdoor	vehicles, talking	good	medium	
R0sjB1Sd1kc					content
R1XD5m-WWRE	edited sound				
R2rrgn8sjA8	edited sound				
r60EIlrif1g	repeat				
R8D__YvEOoQ	fake				
rAOU2gl4kY8	indoor	band			
RBD_Qa-36C0	fake				
RbgxpagCY_c	outdoor	ambient, crowd, talking	good	hard	
RCRBEPA40Jc	fake				
rcYiYe7Cnyk	edited sound				
REtKIWZkspU	fake				
rg_XouytRVg	fake				
rg0ED7lrhD8	deleted				
rG9vF2LAcng	fake				
rHtEdVjDuzU	outdoor	ambient, water			
RI3_GG8QA8U	outdoor	walking	good	hard	
riccApGhD_Q	outdoor	ambient, wind	good		
rIR9Ereztp8	indoor	band			
RKysoro-4Zg					content
rN83eeGTRy4	outdoor	band			
rN83eeGTRy4	indoor	band	good	easy	
rN83eeGTRy4	outdoor	band	good	easy	
rnD-jxGNDEM	fake				
rOWx_uYCDZE	outdoor	ambient, traffic	good		
RQHgYufTbxo	edited sound				
rR8QBdwNTek	deleted				
rrFwyHP3n28	outdoor	ambient, street	good		
rtA9GgMDWPg	fake				
RtdZJtLAcSQ	indoor	band			
RtrL1aWkJg4	indoor	band			
rU4YUbnnxvI	edited sound				
rWDik0AmfIo	outdoor	talking	good	easy	
rXev9QLBJ3Q	fake				
ryieED54LzI	fake				
RYiTVMb_UHg	indoor	band			
RZGe32Mt1dM	fake				
S_PtnU8gEDs	outdoor	band	good	hard	
S-B2wwTKE8I	indoor	band	good	medium	
S-wfIX4PVHM	outdoor	talking, ambient			
S0Q0aFvSg4s	bad ambix				
s3uhYlchbNg	fake				
s5_MyfIIjxc	indoor	talking	good	easy	
S57LL2Y_S1E	fake				
S8CLhH6PTRs	fake				
S9RXGHOap7A	edited sound				
sa05ySco98c	edited sound				
sb37cgYc8zY	indoor	band			
SBBLe89At6k	indoor	band			
sd-W_t7_AMw					content
Sd0zoj1zUQo	edited sound				
sdpp7DWKenQ	indoor	band			
SF4AJHX4BFo	outdoor	ambient, nature			
SFLcGnB0bA0	outdoor	traffic	good	medium	
sggxeMvgpS0	outdoor	ambient, vehicles	good	medium	
sGpdM03_NPk	outdoor	in action sport			
SHHkElE3TTY	outdoor	crowd			
sHmBy75GxIY	deleted				
siSeWKXTSeI	outdoor	crowd			
SJIbpqgYWGw	indoor	band			
Sk0ImQTLcT8	edited sound				
Sle0FLc8Fxk	fake				
SlFajAz3Cx4	indoor	band			
SlswEPy8cjk	outdoor	music	noisy	hard	
SmNhIlOeY0c	fake				
SnRBZqRQfW8	indoor	band	good		
soOmua8AUEk	fake				
SPyK1Gt_Swg	outdoor	ambient			
SQg3kC22LfY	indoor	band			
SQg3kC22LfY	indoor	band			
SQg3kC22LfY	indoor	band			
sRCd03G-51E	fake				
sT_7-mn2NgU	repeat				
su06lbP1A2U	indoor	band		hard	
sVojxB84nqI	fake				
SwdEAhjvXcA	outdoor	ambient, crowd			
SyJ7b0LUVyA	outdoor	band		hard	
sZEvu8vgAy8	outdoor	ambient, traffic	good		
SZYXQ-6bfiQ	outdoor	in action sport			
T1fiWBf6HCw	outdoor	street, crowd			
T1z5q3iTtwo	outdoor	ambient, nature			
T2KX2KnGuUI	fake				
T2tDn4_EDIY	fake				
t3OgV0njs9Y	outdoor	in action sport			
T3sdKU1VTEQ	fake				
T76pw0b33pw	outdoor	ambient			
t7v_EpuwK7c	outdoor	ambient, crowd	good		
TA-bLgrFz-E	deleted				
tAiVUt5vE34	outdoor	motor	good	easy	
tAyThCWKc50	outdoor	in action sport			
tbAM0g42hSQ	indoor	band			
tBNjQPmE1TQ	outdoor	band			
tbTIdAKZaLw	fake				
tc-2k_maUHM	fake				
tC2PA68sCWs	fake				
TCUsegqBZ_M	indoor	band			
TeeHL1W5y3c	fake				
TFhlztBmvBE	repeat				
Tg_p387BYuI	outdoor	water	good		
TgFzcfPvD2U	fake				
TGi41UibZOE	bad ambix				
tgQTPo1BO5Y	fake				
th8FB0NfjDI	bad ambix				
THF8mGzbSgM	edited sound				
TiCXlSfMpuQ	fake				
tKW5RX1T_mU	indoor	band			
tKW5RX1T_mU	indoor	band			
tKW5RX1T_mU	indoor	band			
tm_cPcKcByE	indoor	talking	good		
TMs-GjT_6IA	edited sound				
TNwLn0rn4p0	fake				
tnxru4re8N8	outdoor	ambient, crowd	good	hard	
tqKpROvrBv4	outdoor	ambient, crowd	good	hard	
TR2h98Pgbus	fake				
TseskvwNIRs	edited sound				
Tt4mur95KTo	edited sound				
tUL-L-ooIS8	fake				
TuU7yOyECMY	outdoor	ambient, talking	good		
tv2JkvDltNw	edited sound				
TVm5P91syIg	fake				
tw37UW5VGfg	outdoor	ambient			
tXkPOLj_n48	edited sound				
U_P3QhqG31s	indoor	talking	good		
U-bZKKFcpww	outdoor	ambient, talking	good		
U6AFslTIczA	fake				
U6HbUoVdsNQ	outdoor	ambient	good		
U6zmphY-iHw	outdoor	ambient	good	hard	
u7nXXtYaRro	indoor	band			
UaHfJHcxMdA	edited sound				
uayp7VRoL3Y	indoor	band			
uBBheoNsF9o	deleted				
ubDSY_1A8Ug	outdoor				
uBp-cC_5me0	indoor	music			
UdFAoK7E0io	outdoor	ambient			
ueQGC4JmvxQ	indoor	music	good		
UfGDEXV2F60	outdoor	vehicle, talking	good		
uFhuRP0H5Zc	fake				
uGd5HoH1HBQ	fake				
UgsOaTBIjMo	outdoor	ambient	good	medium	
uk56oPTr7co	edited sound				
UL7DeTQmdHg	repeat				
umjqiH_MZKE	indoor	talking	good		
UmvYr49XLmo	fake				
umXxOxOj0aE	fake				
UpFZ2YaKeqM	indoor	talking	good		
UplpDBT64x4	edited sound				
uPRSAz0nPyY	outdoor	talking, music, ambient	maybe good	hard	lots of scenes
uqcOZw0cSe8	indoor	band			
uQvHKo9gtEs	outdoor	ambient			
uR3wtc8oknM	outdoor	music, ambient	good	hard	
URlLFonfWxk	fake				
Urm5oUH9y7g	fake				
uS1isk-oL1w	fake				
UTPjoPguS80	fake				
uUkEmP1gmEU	outdoor	music, fireworks			
uuuONKRUn_c	outdoor	ambient	good		
ux7WJr70xi4	edited sound				
Uyap960q7yA	edited sound				
v-Y1kmv3zeI	indoor	band			
V2StBoLw8qg	repeat				
v5f-G9Uu5dE	outdoor	water, ambient	good		
V6jsaJ9iydg	fake				
v7i0ygM7w30	outdoor	talking	good	easy	
v7NQ-MI0G7Q	indoor	band, flute	good	easy	
V7ROsJtJRkY	repeat				
vDQSMDn3w9Y	fake				
ve83b67fnO0	fake				
VH2PfGVofiE	edited sound				
vHawmPAmXfs	fake				
ViFMWhSrPt4	fake				
vIwTKLD5_yY	fake				
VIxEHF1_SJM	indoor	band			
vjm4_QuByQY	indoor	band			
VLPTIzE6gws	fake				
voMBpyHf9QE	indoor	band			
vPu-WKfdVC8	edited sound				
vq8tdZUrZ30	outdoor	talking	good		
vqhGhL0san4	fake				
VSPau3HJ3SI	indoor	band			
vT8tla1OKSo	indoor	band		medium	
VtmAz4in8Wo	outdoor	music	good		
VUFKnM21rh8	fake				
vUtEW6OTQLw	indoor	music	good		
vuz52qf3caw	fake				
vvcHrBR0gqc	edited sound				
vvE-91_cFPI	indoor	crowd	good	medium	
Vwf07uS-Gfc	indoor	band			
VWt30ozbPOQ	edited sound				
vwwDwLVXTLI	indoor	talking	good		
VX_gOGFgt14	edited sound				
VxMc3CPU_ZM	edited sound				
vxWpS3ZBxkg	edited sound				
VY0W4RTvoBY	outdoor	ambient, water			
VygVfxkw2d4	edited sound				
vyQzp8V9Q50	indoor	band			
w_gwcBffGm0	indoor	traffic	okay		
w4SYTN12zNo	edited sound				
w4zg6R0vlYY	indoor				
W5CdMA0vUps	indoor	band			
w6xNINF5WCw	fake				
W89CyFCSuFs	bad ambix				
WamDGlFeITE	outdoor	ambient	good		
wBck0kmwO6o	indoor	band			
WbU3_lRa4s8	indoor	band			
WcJVIHIt774	outdoor	crowd	good	hard	
wdUbzdLA8n8	fake				
wFTPuuh7d8A	indoor	ambient	good	medium	lots of silence
WgHYCnMtl44	outdoor	motor, wind			
wgJo8VhVq_o	outdoor	crowd, talking	good	medium	
WgqL4W1sM-4	indoor	band			
wgUHStJkQuA	outdoor	drone			
wgux5WTgDV8	indoor	band			
wGzsTmM6Les	outdoor	ambient	okay		
WHMD6IWOKWA	outdoor	water, crowd	good	medium	
wIXCxGdAnlg	fake				
WJ1djRwaX18	indoor	band			
wjA_EJXr_jY	fake				
WLYIEQ-Fixo	fake				
wm61oYLRlYE	indoor	band			
wmViONWyGSA	indoor	band			
wOSARSqqksk	outdoor	traffic	good		
WPXNB-P4erk	outdoor	drone			
wpZQAgeaXOo	outdoor	traffic	good		
WqCH4DNQBUA	fake				
WQvHH-u9W5w	indoor	band			
WsGjOCPjyB8	edited sound				
wuomHoAyDek	fake				
wWxAvGMR_F8	fake				
wX28jghQv7o	indoor	band			
wXBKQTZbunE	edited sound				
wY-zmYlP028	edited sound				
WZk76BqQsyI	indoor	band			
WzPJ1MNJBDM	outdoor	ambient	good		
X_PbYjFCXjw	indoor	music	good		
X-PXIjJRkss	indoor	band, guitar	good	easy	
X1CtUIbT_bY	fake				
x1gpukNIvlg	indoor	band			
x1lHPvz4s6Y	outdoor	band			
X2-c8c553_Y	indoor	band			
X5uKqELHd30	bad ambix				
x8cwyzroH7E	fake				
xCLfMWy70ME	outdoor	traffic	good		
XDzPs1--avM	fake				
xeWRo3q9pYc	fake				
XhrK24_mQKw	fake				
xI51qNqzZSU	outdoor	water, amient	good		
xke70IUuoLE	indoor	band	good		
xll5T-dWMns	fake				
Xn3cKBWeMqY	outdoor	band			
XNLOFvtQ6vA	fake				
XOy-gHVj0LI	edited sound				
XpQew1uhpbE	indoor	crowd, vehicle	good	medium	
XQ5trbTO93Q	outdoor	ambient	good		
Xr4efy_qyTE	deleted				
xREvnBpwpzQ	outdoor	ambient	good		
xRH8tSDeW5Y	indoor	band			
XSHyjoU5RDc	indoor	band			
XUHXxmUJ7LI	indoor	band			
xUOaJn9K5yk	fake				
xVJsyI0q1Ec	fake				
xw-wlpy8IF8	indoor	band			
XW9ZKfr3ccw	fake				
xwHErVDVDac	edited sound				
XY_LTZ5MxwM	outdoor	talking, ambient	good	medium	
xyccHcWoS74	outdoor	band			
xYz-fDX1bdM	fake				
XzZa_3ejGlA	deleted				
Y-2vFjG-JyI	indoor	talking	good		
y-wMxQ9X3uw	indoor	band			
Y-Y7hO1-tgM	fake				
y1siIqv58Yw	outdoor	water, ambient	good		
Y2u1PrcnylQ	edited sound				
y3WFgR-jzmk	indoor	music	good		
y42GkyrTH64	indoor	band			
Y552m_F8Xbg	outdoor	band			
Y5RRrc9cs4E	outdoor	band	good		
y6VWOitvOzY	fake				
Y7k8C_ar0lg	fake				
ya1HvPbneJ8	outdoor	wind, vehicles			too windy
YB43_nwD9bE	indoor	band			
yb6RsyU42pc	outdoor	music, ambient	good	hard	
YBlwAccoQLg	fake				
yCgqt_wo0B4	indoor	band	good	easy	
yclnEUMUcB4	outdoor	ambient, vehicle	good	medium	
YCMQwbVO38c	fake				
yDrmzsBFJCo	outdoor	ambient	good		
YdttoM3jJIY	indoor	band			
ydzUwFQr53o	outdoor	ambient, vehicle	good	medium	
YEMoaAow4Eg	fake				
yePCPlu8w6E	outdoor	music, ambient		hard	loud music
YGE3MU4NKIE	edited sound				
yJEnS5eHckw	indoor	band			
YJF-H2O5On4	repeat				
YKqkiq7quIQ	fake				
yLlMKzmlF28	outdoor	talking, ambient		hard	lots of noise
ym9Og6T4RGo	edited sound				
YMUV3i7dl4U	indoor	band			
yOaFkEKPD5U	fake				
YogGHyqrzyA	fake				
yoppJCR8d00	bad ambix				
yRbCNU7CsCM	outdoor	talking, traffic, windy	good		
yrhUflv7MSc	indoor	vehicle	good	medium	
YSTkFcvh9rk	edited sound				
ytU2O3QtMjw	indoor	band			
yUTObNo1c_o	outdoor	ambient, vehicle	good	medium	
yvCsC5dXiec	fake				
yVLfEHXQk08	fake				
YvYwDivbHgw	fake				
yw66N5ur_nU	fake				
ywLVTGfu-sM	outdoor	ambient			
yWnsKW7mQf8	indoor	band			
yXi0NvLN2Is	outdoor	crowd, talking			
YxP2cUNkvSw	outdoor	ambient, music		hard	
Yyr_hgw7nWA	indoor	band			
yyweeKJgIcQ	indoor	band			
YZR56hAPnbM	indoor	talking, traffic	good		
z_nSkt2mWT0	fake	ambient			
z_PJ6PXI-A4	outdoor	wind, ambient		hard	lots of noise
z_RHMC7qAJM	indoor	band			
Z1iDA--IZM4	outdoor	crowd			
z1J4VXl6BkI	fake				too noisy
Z1SDVMmWeqA	outdoor	ambient, walking	good	medium	
z2l1r8HIDrI	fake				
Z6WythKW2y0	fake				
Z8W-PtCBmCk	fake				
Z9KrqPWZk_E	fake				
ZAQwr9aJoSg	indoor	band			
ZCwEnhNl6sY	repeat				
ZDR0x2s4ixI	fake				
zEi-FZWutkk	fake				
Zfp2sj4Tzk0	outdoor	ambient, waves	good		
ziZQQGeZ1e8	edited sound	talking			
ZJXd67Np16M	outdoor	talking,ambient	good	medium	
zk1us0NYfug	fake				
zKlAFc39qFs	outdoor	band			
zmfLbjFuA5w	fake				
ZN3HXxi4ccA	fake				
ZNDjb3FRT5c	fake				
ZoSJptgd6Eo	outdoor	crowd	good	hard	
zpvdArfHfjI	deleted				
ZpXoRPNRqic	fake				
zpZrTzc9Yek	outdoor	biking		hard	
ZqJseEWq3F4	deleted				
zSRRoMfHVbg	edited sound				
zTT7UCSF7P0	fake				
ZTVBo8Bc_8E	edited sound				
ZuXCMpVR24I	outdoor	talking	good		
ZVc4WU2xCXk	outdoor	band			
ZW0jObNmBWo	indoor	talking	good	hard	
ZWdhKE6XumQ	fake				
zwxXC7gLTEY	outdoor	ambient, waves			
ZxFQq8y28tY	indoor	talking, minimum edited sound	good	hard	
Zxm4ox45HcU	fake				
ZyVVGQWbNzk	fake				
z15HgMkRuVU	outdoor	ambient, wind, motor			
_C3mZiyc3-s	indoor	band			
bYND913Rupk	fake				
TTt5jLO_X2c	outdoor	ambient, crowd	good		
a_4b-sXEjn4	fake				
866j-XIZmjg	indoor	talking	good	easy	
gqLmxlTXU64	outdoor	ambient, crowd	good	easy	
_XwMUpA5K30	indoor	band			
8ipqUJ2YBM4	fake				
giTHpww2FHo	indoor	talking	good	easy	
B19UIiTfdq4	fake				
jMz0QkOKaGw	outdoor	ambient	good	easy	
ZVWcmGnfCtk	outdoor	ambient	good	medium	
f6njWBlFK3I	indoor	band			
btHOiidPyA0	bad ambix				
wbxEZtjx1lg	outdoor	chickens	good	easy	
tnLSwSjQY_E	outdoor	band			
uRtzWu5pfpQ	outdoor	ambient, talking	good	easy	
V3zp7XOGBhs	indoor	band			
Otks9WevdYg	outdoor	wind, bike			
1cr_tcBus14	indoor	band	good		
MlZxhAy17_c	outdoor	ambient			
PgcHodbB3Vg	fake				
hZBRLw6PokM	indoor	band, concert			
0d8eQVPYjNM	outdoor	ambient, crowd			
d11OlJ8s8W0	outdoor	ambient, crowd			
DJr4GJV6L1Y	outdoor	motor			
Ita4gePxf9s	fake				
6hn-iB87Mvk	outdoor	plane			
iGuCpdwkMvM	indoor	band			
8DfJ8Gab5ss	outdoor	ambient, nature	good		
cc4inO4do34	edited sound				
q9i1neIo2pc	outdoor	action sport			
cVS9DKDy6ts	edited sound				
gq9VRNUqI4k	outdoor	ambient	good		
pQ2q6tQyHXc	indoor	band			
5REgF4xuAmY	indoor	band			
lx5W2LJ5zS0	indoor	talking	good		
Ap7lL1kKdtg	fake				
zja_kP413FM	fake				
bvc6v-zj1-o	outdoor	ambient, motor	good		
v1NChOOfV8k	fake				
qoyZ_AEnmVs	outdoor	ambient	good		
LMcEdI2d5lE	fake				
7WRsz_CAP5M	indoor	talking	good		
5g_BM0HbWzc	fake				
_bQA6ODNAS0	indoor	talking	good		
aieThfuvmtY	outdoor	ambient, parade	good		
I13wYBLY0Ko	indoor	band			
S4hzEknI1WA	outdoor	motor			
u2n_2JxO-aI	fake				
Up3N5pL04ho	outdoor	talking	good		
8ESEI0bqrJ4	indoor	band			
KwvVeXkp_3Q	fake				
emNFqqLdjh0	deleted				
8r8enOjz78Q	fake				
Xdi39XypbLM	outdoor	music, ambient	good		
CdZ68Xzz9CU	outdoor	talking	good		
JKm3uzL_A4c	fake				
Bd3abG_YQJY	outdoor	band	good		
0B6A8rQiTlc	outdoor	ambient, waves	good		
86cnLSmFsjg	fake				
LV5W-3F9akE	edited sound				
i3tnNk_jnAw	indoor	band			
luMEfbJInw0	indoor	band			
9P8vvskh5ck	fake				
rV7ZH0b22Nk	indoor	band			
i9170f5t-4s	fake				
gsWoN6uGM9c	outdoor	ambient	good		
A551Ax3BGcw	outdoor	action sport			
gTB1nfK-0Ac	indoor	piano	good		
8Z7b16jw1G4	fake				
9xK2f3WzlE8	fake				
9SNt5luwwsU	indoor	band			
aZevq_sXyCg	bad ambix				
9jp0F1nNgPI	fake				
bA_7toCijrk	fake				
_vtqcgD7nks	indoor	band			
ANDEUDt7FLw	outdoor	ambient, motor			
m9AcUM0ZaL4	indoor	talking	good	easy	
kt70EFCFAGo	outdoor	plane, motor	good	medium	
VBgNSpGUJDM	indoor	band			
YCDVFF6-AOs	edited sound				
4LkMYkTJ8jw	outdoor	action sport			
EQUFZr6P9Sk	fake				
HlFrYtllnkU	indoor	band			
z_y8cn6bSPE	outdoor	crowd	good	hard	
CswBW0WmckM	fake				
GxWXGAwSRLA	outdoor	action sport			
-PDrGXHLpKM	outdoor	ambient	good		
Cj0m3FhqMJE	fake				
HxHIYhThBFQ	indoor	band	good		
bNwlRzDBYiw	outdoor	crowd			
bBSs8gk_srE	outdoor	talking	good		
dPNQGHG7EvM	edited sound				
CXLfvK0KXgQ	outdoor	ambient	good		
yEmnMCi8y5w	indoor	movie	good	medium	
VNr-6x188D0	edited sound				
CW9NulhMq_Y	outdoor	crowd	good	hard	
1orBujATQSc	outdoor	action sport			
ByBF08H-wDA	outdoor	train	good		
bOnG-bdF8qk	fake				
F8AHMuYc-KE	edited sound				
tVSATje07as	outdoor	music	good	easy	
AteCs2zjmow	indoor	band			
ZqifpNC_oAs	outdoor	action sport			
4NA4vBYydBg	fake				
J0dADXOu560	outdoor	ambient	good		
9X2wM6HD_og	outdoor	firework			
RGzcsBqIbPk	indoor	talking, crowd			
8feS1rNYEbg	indoor	band			
CIoepCR9NSU	indoor	talking	good		
bwP1NkqJnKU	outdoor	band			
umMNfyj44Qk	fake				
99qPM4i1GnE	outdoor	ambient	good		
bQum-XeMp4A	indoor	band			
arYUmX-KOHs	fake				
eDW3hUdHG00	outdoor	ambient, crowd	good		
eqmjLZGZ36k	indoor	motor			
P6JTa_x56Ys	fake				
BgeTUU5SCJk	indoor	talking	good	easy	
1wlq-A6rDqQ	indoor	band			
ofrIqZrMBCg	indoor	band			
Kh6TcYN-M18	outdoor	action sport			
asJjdEJCt30	fake				
vzjSs4eNdjg	outdoor	action sport			
BWkDK1hhoz0	indoor	band	good		
Il1AuDk1nZw	indoor	band			
aJb7imsfuRc	fake				
CX4KuIBmnjI	fake				
ATV2p-qxV7o	outdoor	talking, ambient	good		
vWnGcjhbs_s	edited sound				
UJM3krUkz1o	outdoor	ambient	good		
CZ6rlxfdHBQ	outdoor	action sport			
xjgPW877Ho8	outdoor	band			
Igof7jUIaaE	fake				
ttUD_ffjJhk	edited sound				
baRj0O4cqgI	indoor	band			
bKV1IS-ATmQ	outdoor	action sport	good		
2HilMYC02eE	outdoor	drone			
MMJEW0bWdVE	indoor	crowd			
x95SOBfrIzg	indoor	band			
--cwFrYcs7U	deleted				
ey9J7w98wlI	indoor	talking	good		
hlYp3guu01o	edited sound				
tcz9Mzzm1p4	long talk				
97pAdzsZSqo	indoor	talking	good		
KstT_XlmemE	fake				
eQWVkrT37Qs	fake				
anedUN60dVQ	indoor	talking	good		
IFvXPXgSKjE	outdoor	ambient	good		
S4v9RZyyC3g	indoor	band			
z15HgMkRuVU	outdoor	wind, cycling			
idLVnagjl_s	indoor	talking	good	easy	
WPUaB4G77S8	outdoor	water	good	easy	
WQowtvJjCeE	outdoor	band			
TaZui8Qckm4	outdoor	underwater			
h5eb7vQhRhI	indoor	band			
vusbZ2vyWSU	edited sound				
Uy5LTocHmoA	indoor	talking	good	medium	
ch1UGNF-8qA	outdoor	motor			
ndUaSjcgrfM	fake				
jtVAPRq3wgk	outdoor	wind, cycling			
B83aBccMDEQ	indoor	band			
9MaPyH0Iq_s	outdoor	motor, talking			
dQaNzwqCUAA	outdoor	ambient			
trBL-lI1BDo	edited sound				
0hLcRQXM1FU	fake				
QP7aBPbCO5g	outdoor	cycling			
aNMEY_wK_O4	outdoor	water, ambient	good	easy	
TTt5jLO_X2c	indoor	market, ambient, crowd	good	hard	
edEidt8W3Yg	indoor	band			
0TkrHIY0Qpk	outdoor	crowd, ambient, cars	good		
2VP929E1o2E	outdoor	talk	good	easy	
4gB2vlrO-SA	outdoor	sailing			
k3hCZhswS1Y	indoor	theme park			
nT89mPyXcZU	edited sound				
f6njWBlFK3I	indoor	band			
#NAME?	fake				
KzcOQkAwOTs	edited sound				
I0adP8isw8k	outdoor	wind, cycling			
s52PkEiRN_o	fake				
XzoOMQCQanU	outdoor	water	good		
5OcAVscXQJE	indoor	band			
-sbx3uVDRTY	outdoor	crowd			
VorNgfwPrek	outdoor	steps	good	medium	
IR4uPJm7X8A	outdoor	motor			
bTiep5Pb208	indoor	talking	good	easy	
Lr37_cXUV-M	edited sound				
N3TS8nu0wb0	outdoor	talking	good	medium	
GvvKXoCqoZY	fake				
SG2VLfHU-BQ	outdoor	motor, wind			
tVSATje07as	outdoor	band	good		
U8LhFYUX-LI	edited sound				
UQ2K1W-izdM	outdoor	crowd, wind			
vLXJpEux3ZQ	indoor	crowd, talking	good	easy	
Jk52C0YewVs	fake				
jMz0QkOKaGw	outdoor	walking	good		
4vMiWz7gt_0	outdoor	wind			
ZoIavkWKJvs	repeat				
V2ZynThdr90	outdoor	talking, crowd			
jUnpO2_n6zI	fake				
eM0ggaX5hUo	outdoor	drone			
na769RtwO4s	outdoor	skyjump, wind			
9mw2Clxxwmo	edited sound				
ZVWcmGnfCtk	edited sound				
nd9n8WBWaC4	indoor	talking	good		
I2V_12oQuQo	outdoor	cycling, wind			
pA6YEgT1dLY	outdoor	ambient	good		
A4LXLOy7_ts	indoor	crowd	good	hard	
rfuTXPA80mc	repeat				
ZYlHNBlE6QI	indoor	piano, band	good		
c1vtblAxLu4	fake				
DWphTwyz7-Q	outdoor	motor, talking			
IJAYDK-d7RQ	edited sound				
TWsixmdzsnI	indoor	band			
_vtqcgD7nks	indoor	band			
3xImP9r-G7Q	outdoor	ambient	good		
PQ6lishRYH4	outdoor	theme park			
QLpjYnVPQew	edited sound				
wbxEZtjx1lg	outdoor	ambient	good		
E6QNIicrz8A	edited sound				
UTgWLbuCWDo	indoor	band			
_ONsnpRx4hE	outdoor	ambient, wind			
4NA4vBYydBg	fake				
DOxDUF41lrY	outdoor	skyjump, wind			
m3Z74OVczNU	indoor	band			
gkcVbhfvnGI	indoor	band			
U_E5xJaBgV4	outdoor	crowd, talking, water			
6y3FgUDPTgc	fake				
CzU3_kSlKAs	indoor	band			
1hNl3SYJDAc	outdoor	motor, plane			
RSn20tJsvZQ	outdoor	ambient, motor	good	medium	
j7D4hMz_KSI	outdoor	crowd			
Xx_2vIKfP1c	fake				
MGccNHqSJpg	edited sound				
gwFhKBOJCEw	indoor	talking, ambient	good	medium	
GCydJe2p0zs	indoor	band			
rLDPDjx0Ll8	indoor	band			
uRtzWu5pfpQ	edited sound				
qE8_sstg78k	outdoor	talking	good	medium	
J3lcxSmzX38	edited sound				
kj-OlMi-kSI	edited sound				
q33NhQeJxmw	fake				
V3zp7XOGBhs	indoor	band			
kAM65n9hZp4	edited sound				
SrpUSIPxgqk	outdoor	underwater	good		
pI7eN_Mpy64	outdoor	motor, wind			
HcIJK8y6jRY	outdoor	ambient, talking	good	easy	
rV7ZH0b22Nk	indoor	band			
SIjrs7oxJr0	outdoor	ambient, talking	good	medium	
Kbr0l34rxv4	fake				
hLl1uHlPYKs	indoor	band	good	easy	
sPdfBUAWH2M	fake				
Vh7S4HvULN0	indoor	talking	good	medium	
Oh0yA3yHrDQ	indoor	band			
qZkGmCidn50	outdoor	motor, wind			
Ag-cpNluY5g	outdoor	crowd			
AOOeEwKy5KE	outdoor	band			
4LkMYkTJ8jw	outdoor	ambient, steps	good	easy	
1cr_tcBus14	indoor	band	good	easy	
MlZxhAy17_c	outdoor	ambient, water			
a_C-Wa4gNHA	indoor	band			
EGv5HWkSfuo	fake				
vf2Nd2kYEc0	outdoor	ambient, talking, crowd	good	medium	
Hh8sTR2b4zI	fake				
AaJX17II-qw	fake				
hZBRLw6PokM	indoor	band, concert			
WMZAENL9oFw	outdoor	crowd, music			
bgS2S_kPUts	outdoor	band, talking			
9ePGwHMPkpM	edited sound				
M66mQf3tnKE	edited sound				
oGnS0j3knS4	edited sound				
bg1q5HByCuI	edited sound				
0d8eQVPYjNM	edited sound				
2ZugmhAni-M	edited sound				
hS-kqQ7FmXw	edited sound				
4p_Uihxhjys	outdoor	ambient			
VsE5NQ89WU0	edited sound				
jmomkRqT7oQ	indoor	talking	good	easy	
v4lbwuoHnjM	outdoor	talking	good	easy	
Rek6HnrsqLA	edited sound				
ONmqO4OiWtw	bad ambix				
DJr4GJV6L1Y	outdoor	motor			
ktFMDkRBXrg	outdoor	motor			
7nafZL0NXlA	indoor	band			
Ita4gePxf9s	edited sound				
CKhRum1bzhk	edited sound				
6hn-iB87Mvk	outdoor	motor, plane			
1UakP0YL25s	edited sound				
sKqwSHAZgGY	indoor	talking	good	easy	
X5MFkY0Nz3Q	outdoor	underwater			
Su_b25Y5NUs	outdoor	wind, motor			
iGuCpdwkMvM	indoor	band			
mtDAcfdZuHk	edited sound				
WuSNT1be-n0	outdoor	motor, talking	good	medium	
BuuVgZZM878	indoor	train, crowd	good	hard	
tl2IIIQCdbQ	outdoor	walking, nature	good		
cWjGQtbyYFE	outdoor	wind, cycling			
rXRLQSiFk2s	outdoor	wind, motor	good		
1zt87XCWlWs	indoor	talking	good	easy	
wTUuzWCHAk0	indoor	band			
89gYvp_7Nrw	edited sound				
Xdi39XypbLM	edited sound				
H3H2yM3se2U	indoor	band			
3LHzz9mOv-Q	outdoor	talking, wind, crowd			
owqYKVUUTmw	edited sound				
jEUnBEKEKCs	fake				
hZ5YRG2wOSs	edited sound				
cWY79qh7uMQ	outdoor	wind, motor			
NltGSmM8oIE	fake				
T4bIg8VkGEw	edited sound				
OGnAacE2pDM	fake				
q9i1neIo2pc	outdoor	wind, cycling			
5OPA96bfkdo	fake				
PB0H3rSBMD8	outdoor	walking	good	medium	
BgU98DTN6QY	outdoor	motor			
uhDs2ABtxGw	edited sound				
sjIoaIdrA5E	edited sound				
7UNVSS9ZidM	indoor	band	good	easy	
Dq8BO3ugeGE	outdoor	wind, cycling			
Ztqy3JOINsI	fake				
5REgF4xuAmY	indoor	band, choir			
lBKtOdmFtnI	indoor	crowd, market			
lx5W2LJ5zS0	indoor	talking, crowd			
e8DOBptHEpE	outdoor	sky, wind			
MgLX0EXju30	outdoor	motor	good	hard	
Pyk2cjuEDGc	outdoor	ambient, wind, water	good		
_Fc2MS-waEk	fake				
Bbd_e5g5SKw	outdoor	motor			
3GFsHNgcjNw	fake				
fdc6XMVmY6E	edited sound				
vHyHo04hby0	fake				
vSeMaelQZvQ	fake				
ppSeAw64M2A	edited sound				
ULNgwD-lrno	fake				
MJelc0iYv5g	outdoor	wind, cycling			
OWLW_YQ4tUI	edited sound				
v1NChOOfV8k	outdoor	ambient, piano	good	easy	
qXKK5EqQaEk	outdoor	train	good	easy	
rNyriLZzAqY	outdoor	water	good	medium	
HMYl0i9UBg8	fake				
c4DbdubFuEk	outdoor	band			
NzoFYJTLaOU	outdoor	ball			
3ja2teDnx_I	indoor	band			
b5aiAH-d_T0	edited sound				
UPWpvPz4RoU	fake				
C7_O5BZz0Eo	indoor	talking	good	easy	
p6szivyVHYA	fake				
awOK5ayCJao	outdoor	crowd, music			
8JwsTjoA0UI	outdoor	crowd, cars	good	medium	
WhB7Id09JuQ	indoor	band			
VIxpTbs9V8M	edited sound				
1_tl2zBS0j4	indoor	cars	good	medium	
1iYuVp6TTZ4	fake				
8CJcfZtbZ2U	outdoor	ambient, water	good		
Ch4uTD4FVlk	indoor	band			
e8ZQs4tXyU0	edited sound			medium	
ifurLY3mRF4	outdoor	talking, running	good	easy	
idZ4FhejY4E	outdoor	talking	good		
UJM3krUkz1o	outdoor	cars, wind	good		
V8UBNttMWJo	fake				
gufqe78o1hM	fake				
30M7rreJ2zM	outdoor	wind, sailing			
LMcEdI2d5lE	edited sound				
Q3dST2li9Wg	outdoor	theme park			
y87iv7y6uoQ	indoor	crowd			
56auoHZucuk	outdoor	band			
K5wRFDk2H7o	outdoor	motor, wind			
CFft3TUgqEI	outdoor	walking			
SdGCX2H-_Uk	indoor	band	good		
I13wYBLY0Ko	indoor	band			
YpoXMebAYgE	indoor	music			
MlDnShLtcks	outdoor	music			
mSSbz7bIp4I	edited sound				
70YT_88_t7Q	outdoor	human, nature	good	easy	
6NXhraaPkg0	outdoor	wind			
Pl-rLdpbTE0	edited sound				
dSHa4-xktlI	outdoor	motor			
HlFrYtllnkU	indoor	band			
H7BwYH8VxPE	fake				
UTzdbkqmFI0	outdoor	crowd			
r6pD8uxgejo	outdoor	human, nature			
uS_PZHidou4	outdoor	wave	good	medium	
cKw1_l3htvA	fake				
kt70EFCFAGo	outdoor	motor			
OLBCzxzvBZM	edited sound				
FriGQ0NVdsg	fake				
Up3N5pL04ho	outdoor	human	good	easy	
ZOqHvzhhb_8	outdoor	crowd			
5XS0gKZC-_w	edited sound				
MOkShC6Mfdo	outdoor	crowd			
N3tM4aouaIc	fake				
1CH-d4ER61U	outdoor	cars	good	medium	
Atww9g1Ge9o	bad ambix				
itrGvpJBJHU	outdoor	drone			
8DfJ8Gab5ss	outdoor	human	good		
_hv80O8orKE	outdoor	moto, wind			
zVFxyBgTLig	outdoor	human			
py0ZFyoSxTU	edited sound				
KXIFTcHZzgU	indoor	band			
fUSnjhWRZ8U	indoor	crowd			
tyTG1zGB2Xc	fake				
vHnQrPRWaPw	outdoor	wind, car			
5X0q6wmUwyw	outdoor	car	good	medium	
A0n0gIf-sGM	edited sound				
DdQzV2kKzf4	outdoor	human	good	medium	
FqaKhYKEI-A	indoor	attraction			
cfQArtJ0PAM	outdoor	water, human, wind		medium	
b89jFwEBmYE	fake				
p58TcFAlD_Y	outdoor	human, bike, wind			
fP6KTL28GD0	outdoor	crowd			
pedNfNtzaVw	indoor	band			
GiGoLFs4q7U	outdoor	wind			
JLxwrHi-YMk	edited sound				
i1OVkXE-scU	outdoor	drone			
cktjeMD2tiE	indoor	human	good		
JKm3uzL_A4c	edited sound				
i3tnNk_jnAw	indoor	band			
ZVlVcEIo3Ws	outdoor	human, car	good	medium	
IRG9Z7Y2uS4	indoor	human	good	easy	
jLcOO3V1afI	outdoor	wave	good	easy	
oP_-4UWeIKo	fake				
5g8UsTKizbM	indoor	crowd			
SPCN2MSdSa0	edited sound				
vIcJjsK-gco	indoor	human, cave			
iHK6snhYXbI	fake				
ZSXnw-fJbGk	edited sound				
Ztu9EH6UQso	edited sound				
Vyn4x0Gbn_0	indoor	water	good		
LV5W-3F9akE	fake				
vjSKxFfjg8c	indoor	vacuum			
v5yJQDI-7js	fake				
Tuv6xisdZ3I	repeat	band			
eihJpcAQVAE	outdoor	cycling, wind			
NjKxKIaS23Q	outdoor	motor, wind			
3N1FYFEJnaQ	fake				
WaAmpGDdTDM	indoor	human	good	easy	
BziANtuSVnA	fake				
t0QriZ5kJH0	outdoor	crowd	good	medium	
wh68CH4K2L0	edited sound				
eWsbggozZS4	indoor	band			
RLHZ56L4kQs	fake				
rp4Sgce2y3E	edited sound				
7P37xEKbLrQ	indoor	human, crowd			
jNZ1ybTMab4	edited sound				
DunzYN7eHzw	edited sound				
O51dYZERhkE	outdoor	wind, nature	good		
OnNd4afzHp8	fake				
Sdntwm_Q1Zo	outdoor	crowd	good		
mNrrRIFRlJA	outdoor	crowd	good		
Oak26yVbibQ	indoor	band			
z8reE_wMJms	edited sound				
Nv_K2XR2ZBs	outdoor	nature			
DAXcwa_HooQ	outdoor	hiking	good	easy	
hFf38TisIzw	edited sound				
RrGhiInqXhc	outdoor	hiking	good	medium	
JvZeogS1wE4	bad ambix				
ynZjPq4lc0w	outdoor	running	good	easy	
wv7OxouKZsc	outdoor	running	good	easy	
A551Ax3BGcw	outdoor	windsurf, wind			
nxzrPf0IsUU	outdoor	human	good	medium	
hoq-DkykYdQ	outdoor	crowd			
MjehJ4T_LKI	outdoor	human	good		
uPs041J9pnY	indoor	band			
AkrX8q82IAo	indoor	band			
PCZ0CV0rUGA	outdoor	wind, jetsky			
fAF562JqtT4	fake				
csW7DQdft-E	outdoor	motor	good		
fJwRs8NdFIg	fake				
H9R0Hp81MOE	indoor	band			
B8R148hFxPw	fake				
FXrymP-Xr1g	outdoor	crowd			
H5gErlTw24g	edited sound				
gTB1nfK-0Ac	indoor	band			
ibFFlCL0MBk	fake				
MAY9P2PCu-c	outdoor	human, canoying	good	medium	
rbRQGsEDwwM	outdoor	motor, wind			
2jsNxK8g0_4	fake				
w8zTGObKjKE	edited sound				
x95SOBfrIzg	indoor	band			
cra47dFcXzE	edited sound				
WBX2EYbGqh0	fake				
nMm2N4XwEKA	indoor	theme park			
JQtBu7eNKew	indoor	acquarium			
dQYRpIGXvYk	outdoor	cycling, wind			
Au5ro1NOnhI	fake				
DP_qVxVD3uQ	outdoor	hiking	good		
s1ZEGOsWQ4A	fake				
gz2DSEVaojk	outdoor	wind			
JmkxA6PAaIg	edited sound				
SgMWGmIe3lE	outdoor	drone			
13Ai7eE9He8	edited sound				
2mLl01-QnaM	fake				
eGGFGota5_A	outdoor	human	good	easy	
jupyg7SvZm8	edited sound				
RQp1HbiEiSI	indoor	band			
BMqg6462oDY	fake				
I4Imhb_UqgI	indoor	band	good		
siGqdp4Wpak	outdoor	wind			
9yzuI5W2EzA	indoor	talking	good		
m0kXQPIjgbo	outdoor	hiking, human	good		
LKBNEEY-c3s	fake				
nWxIAVQpv8E	indoor	band			
WV4m9MRFP5o	outdoor	human, water	good		
QOuFJQUzEZs	fake				
SeLJChGJ7iM	outdoor	cars			
VRoVjpa3Scg	outdoor	drone			
z5toF7ZLPsY	indoor	band	good		
HqOhvoxC7Po	outdoor	motor, wind			
OUpviBx5YlE	fake				
m9AcUM0ZaL4	indoor	human	good		
hbJ8jURg1ws	outdoor	motor, wind			
hn1vmNNdJeE	fake				
5d9XEfAM0yE	indoor	band			
Qxy74ALZUws	fake				
VBgNSpGUJDM	indoor	band			
rL2MSs1a0mw	fake				
YCDVFF6-AOs	edited sound				
NHTvCczabDA	edited sound				
ZsbKQkMfReY	edited sound				
7tkbZB42LQ8	fake				
Zd-k_jrgDJk	fake				
gzUVlpffsbE	indoor	human			
ZBXiIs_4H6M	outdoor	human, canoe	good		
ow_J6NUSFbs	edited sound				
z_y8cn6bSPE	outdoor	human	good		
7duhBOM-J78	outdoor	ambient	good		
kstku8mnMRk	fake				
e5_EE7Hpr6I	fake				
Ra9FqlaaeK8	indoor	band			
x_Kj2uV8YmI	outdoor	crowd	good		
J6yMf10p2U8	outdoor	ambient			
sufIFTMT-tU	indoor	band	good	easy	
YZ91u4s8VrA	outdoor	cycling, wind			
ezrte_Yy3GY	fake				
P9iH8NvaUXw	outdoor	human	good		
MMbKWxiDTxQ	outdoor	ambient, wind			
bX95LotTxIc	indoor	band			
DO6_Rp_ZDCw	outdoor	wind, motor			
R_WkH_uOq1Y	outdoor	motor	good		
nFus93rfqP4	fake				
cAgl_6a76fY	outdoor	wind			
aMceWER4mfA	fake				
GxWXGAwSRLA	outdoor	motor, wind			
sRwW-xIairc	fake				
ucT5i-6HKzA	fake				
X76mt1s2Vl4	indoor	human	good	easy	
xCp4at6LE0A	fake				
Coz6Vq5UNog	edited sound				
PFRZup359ps	fake				
UF84AaB7n_o	fake				
1P18VziL9Gk	outdoor	drone			
OQQi0DPZAwM	indoor	human, crwod	good	hard	
S9w8HIDshPY	indoor	human, crwod	good	hard	
luMEfbJInw0	indoor	band			
HxHIYhThBFQ	indoor	band			
Un0LWhH-9CI	edited sound				
axt4QlZiiP8	outdoor	human	good		
us4krTa13QY	outdoor	water	good	easy	
ntaas4h34mQ	fake				
Jc7mqsD_sWM	edited sound				
L9peD3kK5sw	fake				
JnAYux4zpmU	edited sound				
woqNEE20HhI	outdoor	wind			
fGaRV_0xl-c	outdoor	human	good	easy	
ofrIqZrMBCg	indoor	band			
719-xjyMtPk	outdoor	crowd, music			
zja_kP413FM	fake				
ZYQQVkcxvwI	edited sound				
pTvI1gGoZHE	fake				
REe7T0TFNGA	fake				
BIrH5_kvgLc	outdoor	water, human	good		
4SilhsTuDU0	indoor	human	good	easy	
N6UH-jzU5Hw	outdoor	steps	good		
NOaZLo7ulJU	fake				
jfy1J6exPXs	outdoor	water	good		
1orBujATQSc	outdoor	cycling, wind			
xQq5-JtVbTo	fake				
O3NLaKxgOIg	outdoor	ambient	good		
FV_qMvEv1gs	fake				
rzJDcwiwDUA	outdoor	ambient, water	good		
HnUVz0J2CoE	outdoor	cars, human	good		
G3-VggU7A_A	fake				
4TLZTQyVhhg	edited sound				
oL9MH1Q5Cgg	outdoor	human, water	good		
UsYtt2zjq5Q	indoor	human, crowd			
U2LL2RXleiM	outdoor	motor, wind			
uRlaE5dYNFc	fake				
GcKeKmHi--A	outdoor	water	good		
OZOaN_5ymrc	outdoor	band			
0febG_1e-fY	indoor	band			
uhIVgNOsziE	edited sound				
nsPIVADn-FE	repeat				
0WJzAxVDi_8	outdoor	human, ambient	good	easy	
iZeA7nPngOI	edited sound				
tzMY6--nlvs	outdoor	drone			
XKuiBH9PQfY	indoor	band			
d7xwsSxV8Os	outdoor	wind, car			
JbGlLbNYBy8	outdoor	water	good		
wllmx36M2uI	indoor	band	good		
tGUkOReZW9s	indoor	band			
_Cm9OW6caCo	edited sound				
j9WvTZ9ysUc	outdoor	car, human, noisy			
ZqifpNC_oAs	outdoor	motor, wind, water			
JqXC46b1uUg	fake				
qzq5xd6lDAY	fake				
1bg55mXPv2I	fake				
kXqj4APQnqo	outdoor	hiking, human	good		
EOS1kahBbPY	edited sound				
0dil9dqqZiw	outdoor	no sound			
i-JgZ3dRxUM	outdoor	plane			
3djTCRKNvJc	edited sound				
my5DHbLwnLI	indoor	human, crowd			
Fn__BrVR86E	indoor	band			
ZZJ0IEI8N80	indoor	band			
0BDCLo2pioo	bad ambix				
cij3tMB9GJU	fake				
SU-WjRF-_aU	outdoor	underwater			
J0dADXOu560	outdoor	hiking, human	good		
dMYhXvXvQNI	outdoor	wind			
RGzcsBqIbPk	indoor	human, crowd			
EZWtzaTHtXk	outdoor	toycar			
TsXogrnKQIU	outdoor	ducks	good		
OuOqx0Od5mQ	edited sound				
83Gqr8z3S0g	edited sound				
eBlLt8MOHXM	indoor	band			
gz0rSiJZ2wQ	outdoor	motor, wind			
gy4TI-6j5po	outdoor	wind, car			
4BZX_h5Dohk	outdoor	human	good	easy	
XRgAsjKnRKw	outdoor	motor, wind			
4GlgdBAV1TM	outdoor	hiking	good		
tIRcUlpWoh4	edited sound				
bEkJMieCwcg	edited sound				
oWPkYneOFWM	edited sound				
Kguf-ETVfDE	edited sound				
wzWno2uh6fQ	outdoor	crowd, music			
I8Mif36mIRY	edited sound				
GcZn8iDNyn4	outdoor	kayak, human, water	good		
KB3t1tHdXak	edited sound				
FXAJcUvUI8k	outdoor	moto, wind			
IFvXPXgSKjE	outdoor	wind, car	good		
0B6A8rQiTlc	outdoor	wind			
znFV2xkFryI	outdoor	wind, drone			
1k8kQlJ8XH0	outdoor	wave	good		
itxS75ftx4Q	edited sound				
RWc3Xyh_pp4	outdoor	wind, car			
JWO2zjcJqvQ	outdoor	crowd	good		
eqmjLZGZ36k	indoor	factory echo			
THx57-W33NU	outdoor	car, wind			
5xqPUyI3pQY	edited sound				
bnqyJ4Zz9wg	edited sound				
uk5oghq86PY	repeat				
GB8eKtfbBkA	fake				
R0heS5c1VIY	outdoor	car, wind, human			
UPlkR2E_EZk	indoor	human	good		
tBItGu7kbEw	fake				
wgMmUpldVbE	outdoor	crowd, music			
xspTbjeOJuU	outdoor	human	good	medium	
SUCxQQ6ovkQ	fake				
Kh6TcYN-M18	outdoor	bike, wind			
VeMq5i5IeEM	bad ambix				
apD703fuYAo	edited sound				
SMBo1ZlUOmY	indoor	human	good	hard	
4-Bkn7x_9WE	fake				
jOQByNlFn6U	edited sound				
1wlq-A6rDqQ	indoor	band			
b93KCVhNzkI	outdoor	car, wind			
gqLmxlTXU64	outdoor	crowd	good		
BmfOjbEHFto	edited sound				
Utz08swAf88	outdoor	crowd	good		
W6P9tti3bhg	outdoor	crowd	good		
fLY8BgzLvFo	outdoor	carwash			
Otks9WevdYg	outdoor	moto, wind			
Am2ihQfZLm8	outdoor	crowd			
s2Nevqi09W0	outdoor	car, wind, train	good	medium	
SrcDwd65pXc	outdoor	bike, wind			
UWzTxxmGDVg	fake				
vzjSs4eNdjg	outdoor	wave, boat			
skKh5wyzlR0	outdoor	moto, wind			
f7UJ9FwlX-8	outdoor	crowd			
dFq9wbrV-v0	indoor	band			
gxtsecrcRAw	edited sound				
sssLsGfV_Bk	indoor	no sound			
MFVmxoXgeNQ	outdoor	band			
m2FrhDqRFt8	fake				
tmO6N6TBXoE	indoor	piano, tab dancing sound	good		
BUkPV2quBEc	edited sound				
Ayh2JIEMPcM	outdoor	wind			
rstIX0rRXpo	outdoor	crowd			
RSYbTSTz91g	outdoor	cars, wind	good		
Ikgf9nZKZgk	outdoor	car, wind	good		
MNMDORuh5A4	outdoor	car, wind	good		
Hl6R75H0LRE	indoor	crowd			
9m1qXA49zPY	fake				
7HT7AS3UmFI	outdoor	car, wind	good		
CX4KuIBmnjI	edited sound				
sADhlWF2r-Y	edited sound				
Ot2ZMHTKGMs	edited sound				
00Eu5i2mTbw	indoor	human	good	medium	
tN-CkuM6jYs	outdoor	bike, wind			
sDtG_YA7OIs	outdoor	car 	good		
ZUKDruKG8UE	edited sound				
W0tEjOPwFjM	outdoor	music, human	good		
jeE8Vr9dEVg	outdoor	water bubble			
S2LPdiqOVEk	outdoor	wind			
rPO-xNyu-74	edited sound				
gCeAiupiKoo	edited sound				
C1fK650VlbU	outdoor	human	good	easy	
VdGS6I09l_8	indoor	crowd			
Q1m4_U9t31U	edited sound				
HzaPzTNjauY	fake				
xjgPW877Ho8	outdoor	band			
iK273cJvPwc	outdoor	moto, wind			
5MOThhaaYsI	edited sound				
Nt5ECvb-CP0	outdoor	human, wind	good		
fQWiuo80ThE	fake				
ttUD_ffjJhk	indoor	wind, machine voice	good		
PCcgw10fEh8	outdoor	moto			
AU3Z8jz5ZBg	outdoor	wind, car			
CGB2ZoVDiQk	indoor	band			
1LDIeHjFvJA	fake				
Wfw4es2hwrw	indoor	band			
Bvu9m__ZX60	indoor	band			
_FQFVGi5OPc	outdoor	bike, wind	good		
7et9dPYZFXo	fake				
yk3Sd21RHPE	indoor	kids			
PYz78l0YeV4	fake				
OwjOpt2FCFw	outdoor	echo, wind	good		
2HilMYC02eE	outdoor	drone			
VMYjcjUdLPs	outdoor	airplain	good		
MMJEW0bWdVE	outdoor	crowd			
M1WwelWfWHQ	outdoor	car, music			
NP8U1w6jMbw	fake				
-tOdJzOzkHA	outdoor	human, music, wind			
OLZg3uE2-A4	outdoor	hiking	good		
5CixYdUXwgE	fake				
rdhnDDhLOr8	fake				
Tnaf58Q_1mI	fake				
_gWPBVii9rA	edited sound				
fLSQMpGMv3M	indoor	unidentifiable			
vND8HNXyvIo	outdoor	car, human, car	good		
pQ2q6tQyHXc	indoor	band			
QVgYAUdTIRI	outdoor	wind, moto			
IOh_FP18Kuc	fake				
-PDrGXHLpKM	outdoor	crowd	good		
mn3ZaG_i6y8	indoor	band			
nYqE3jFp-YM	outdoor	car, wind			
drg0b7ywZ1o	fake				
f04oxPdEjOw	outdoor	band			
hlYp3guu01o	edited sound				
fw4Tjyc0bwU	outdoor	no sound			
RHhWHAZaCS0	indoor	instrument, echo, human	good		
QGWcgAN4nJo	outdoor	human, wind, sand bag	good	medium	
2KoS5w1HOZE	fake				
J4IkhD6Eark	outdoor	helicopter, wind			
KOxPkbOUzV0	outdoor	bike, wind			
e6ZSBe_Zrjg	outdoor	crowd			
KstT_XlmemE	outdoor	no sound			
wH6f1T9kcYo	outdoor	human	good		
jm3dpBaUULI	outdoor	human, echo	good		
RsE-uLbCykQ	indoor	band	good		
eQWVkrT37Qs	fake				
ZQqDZzXoDPc	repeat				
AwL8gKLUXNg	edited sound				
b32Q1nTgHM0	edited sound				
3G-jjFJcmM4	outdoor	human	good		
1C-iG9NXen0	outdoor	car, wind			
oDxPIPa0wV8	indoor	band			
AhISnxlonxI	fake				
lVRTR0nfKvw	outdoor	moto, wind			
YSiqRNabL6U	fake				
EQUFZr6P9Sk	fake				
j0RNzPU_yCg	indoor	human, music	good		
OdpM9Mp0Akc	outdoor	wind, airplane, wind, crowd	good		
8IyxdJw5Ug4	edited sound				
nwEQ3oqmwgA	outdoor	wind, bike			
rZAQ29_JfaQ	indoor	band			
KTH6N2n0exc	outdoor	basketball, human	good		
BbPeMSr4DNU	outdoor	wind			
E799pQJv1Mk	outdoor	wind, crowd	good		
GAx-kf_U2fI	fake				
VSPy1d2AIPs	outdoor	bike	good		
7LeXXT-I19Q	outdoor	crowd			
kZB3KMhqqyI	indoor	human			
Xpq5kBcSYCI	edited sound				
-oytwMeyR74	indoor	band			
tmZeR3hiGQM	indoor	band			
QGprj-a71qs	outdoor	doggie, human, wind			
rvl-IqvHrrk	edited sound				
LOnuIU35C-w	outdoor	human, water, wind	good		
AOA3QUQcLwI	outdoor	crowd			
52NNTlLpNMM	indoor	band			
S4v9RZyyC3g	indoor	band			
FLZFxWmvo78	edited sound				
9O4psN_VXNU	outdoor	wind, rain			
vCb0SmnIl-I	outdoor	moto engine, wind	good	medium	
PUzXPm2CEBU	edited sound				
JqGA3ldiXNo	indoor	crowd			
VXp_BlhSbjc	outdoor	human, nature	good	easy	
7muYPid24Ps	indoor	band	good		
P1d1jf7dQ9o	indoor	basketball court, crowd	good		
CRIg8Dqu804	indoor	music			
_B7TWdZIJ3g	edited sound				
X3VMZgOA9RQ	outdoor	crowd			
jtVAPRq3wgk	outdoor	bike, wind			
AI1kS5hz5gM	outdoor	wave	good	medium	
LKWosiUUORs	outdoor	music			
jBK5PMSNkC0	edited sound				
HZYperUFw_g	outdoor	wind			
ytzNJ0UmaSQ	indoor	human	good	easy	
qZ7QSckdUJc	indoor	badminton, echo			
qiTGW6N_gNM	indoor	human	good	hard	
81YGLW_Z8Ms	indoor	band			
qoyZ_AEnmVs	outdoor	birds, water, wind	good		
Ngj6C_RMK1g	indoor	badminton, echo	good		
sTW91HRsybM	outdoor	wind			
0HUUucT-47Y	outdoor	human, car 	good	easy	
gc-CRmiDRHU	outdoor	under the water eco			
bwP1NkqJnKU	outdoor	band, but two people			
769sl6upNEY	outdoor	moto engine, wind			
1po3ma5YHFs	indoor	band, but piano and a person			
bloHPQVpnj8	fake				
fBqz3SYDb2s	outdoor	crowd, band			
_XwMUpA5K30	indoor	band			
ZUim66V_nko	indoor	human	good	easy	
eW_e02pSaG4	edited sound				
b1KhtJdiPkk	outdoor	kayak, wind, water			
Om7kIxFL7hs	outdoor	crowd			
z3XCx5uyVOI	indoor	band			
wrtFLhwu168	edited sound				
sgqUP6Lp2Jc	outdoor	human, wind			